"","Player","Team","Position","GP","TOI","Goals","Total Assists","First Assists","Second Assists","Total Points","IPP"
"406","Nikita Kucherov","T.B","R","82","1229.9833333333","24","45","26","19","69","84.15"
"165","Patrick Kane","CHI","R","81","1414.8666666667","26","40","25","15","66","78.57"
"692","Connor McDavid","EDM","C","78","1362.65","24","40","28","12","64","83.12"
"78","Sidney Crosby","PIT","C","79","1253.2666666667","19","42","31","11","61","74.39"
"238","John Tavares","TOR","C","82","1254.8333333333","33","27","16","11","60","72.29"
"371","Johnny Gaudreau","CGY","L","82","1265.65","23","37","24","13","60","82.19"
"614","Leon Draisaitl","EDM","C","82","1377.95","28","31","17","14","59","79.73"
"743","Artemi Panarin","CBJ","L","79","1264.5666666667","19","40","29","11","59","75.64"
"729","Mitchell Marner","TOR","C, R","82","1212.5666666667","16","42","36","6","58","73.42"
"537","Jake Guentzel","PIT","C, L","82","1280.65","31","26","13","13","57","73.08"
"583","Max Domi","MTL","C, L","82","1134.05","22","31","20","11","53","79.10"
"655","Brayden Point","T.B","C","79","1134.6333333333","19","33","25","8","52","72.22"
"119","Claude Giroux","PHI","C","82","1230.8","16","34","23","11","50","73.53"
"56","Alex Ovechkin","WSH","L","81","1229.8333333333","28","21","14","7","49","65.33"
"577","Sean Monahan","CGY","C","78","1139.75","20","29","21","8","49","75.38"
"107","Brad Marchand","BOS","L","79","1083.9","18","30","16","14","48","78.69"
"184","Steven Stamkos","T.B","C","82","1076.8","22","26","19","7","48","81.36"
"255","Tomas Tatar","MTL","L","80","1081.2833333333","20","28","18","10","48","80.00"
"573","Aleksander Barkov","FLA","C","82","1251.6833333333","18","30","21","9","48","68.57"
"68","David Krejci","BOS","C","81","1140.45","12","35","23","12","47","82.46"
"409","Jonathan Huberdeau","FLA","L","82","1152.8666666667","16","31","25","6","47","81.03"
"572","Nathan MacKinnon","COL","C","82","1363.6666666667","23","24","15","9","47","70.15"
"693","Jack Eichel","BUF","C","77","1161.7333333333","16","31","20","11","47","75.81"
"698","Timo Meier","S.J","R","78","1091.0333333333","22","25","16","9","47","75.81"
"777","Auston Matthews","TOR","C","68","1020.1333333333","23","24","15","9","47","85.45"
"240","Matt Duchene","CBJ, OTT","C","73","1095.3","22","23","15","8","45","72.58"
"330","Tyler Seguin","DAL","C","82","1280.9166666667","19","26","20","6","45","75.00"
"352","Mark Stone","OTT, VGK","R","77","1176.5833333333","22","23","14","9","45","64.29"
"461","Tomas Hertl","S.J","C","77","1035.5666666667","17","28","16","12","45","71.43"
"167","Evgenii Dadonov","FLA","R","82","1142.5833333333","16","28","13","15","44","69.84"
"219","Cam Atkinson","CBJ","R","80","1157.0666666667","25","19","9","10","44","64.71"
"328","Brett Connolly","WSH","R","81","992.63333333333","21","23","13","10","44","77.19"
"784","Alex DeBrincat","CHI","L, R","82","1117.8333333333","24","20","7","13","44","66.67"
"804","Pierre-Luc Dubois","CBJ","C","82","1187.9666666667","20","24","14","10","44","57.89"
"124","Phil Kessel","PIT","R","82","1131.4833333333","15","28","18","10","43","82.69"
"131","Jonathan Toews","CHI","C","82","1224.7","19","24","16","8","43","69.35"
"234","Ryan O'Reilly","STL","C","82","1190.7333333333","18","25","15","10","43","70.49"
"306","Evgeny Kuznetsov","WSH","C","76","1046.4166666667","8","35","20","15","43","71.67"
"413","Mark Scheifele","WPG","C","82","1295.0166666667","20","23","12","11","43","72.88"
"414","Sean Couturier","PHI","C","80","1240.2","21","22","14","8","43","65.15"
"445","Morgan Rielly","TOR","D","82","1502.3333333333","15","28","13","15","43","43.43"
"613","Sam Reinhart","BUF","C","82","1198.7833333333","17","26","17","9","43","72.88"
"39","Brent Burns","S.J","D","82","1517.25","6","36","21","15","42","50.60"
"324","Jeff Skinner","BUF","C, L","82","1210.05","27","15","11","4","42","60.00"
"344","Brendan Gallagher","MTL","R","82","1083.1166666667","28","14","6","8","42","68.85"
"629","Alex Tuch","VGK","R","74","1014.35","14","28","11","17","42","75.00"
"702","Mikko Rantanen","COL","R","74","1160.8166666667","11","31","17","14","42","72.41"
"126","Nicklas Backstrom","WSH","C","80","1118.1166666667","13","28","17","11","41","74.55"
"151","Logan Couture","S.J","C","81","1064.3166666667","17","24","14","10","41","69.49"
"213","Gustav Nyquist","DET, S.J","C, R","81","1169.85","16","25","13","12","41","68.33"
"329","Ryan Johansen","NSH","C","80","1113.3166666667","10","31","19","12","41","67.21"
"626","Dylan Larkin","DET","C","76","1269","16","25","17","8","41","80.39"
"774","Matthew Tkachuk","CGY","L","80","1083","17","24","15","9","41","73.21"
"55","Mark Giordano","CGY","D","78","1331.0166666667","10","30","14","16","40","50.63"
"57","Evgeni Malkin","PIT","C","68","974.23333333333","11","29","20","9","40","90.91"
"59","Blake Wheeler","WPG","R","82","1207.5833333333","13","27","18","9","40","71.43"
"462","Teuvo Teravainen","CAR","L","82","1094.7833333333","11","29","17","12","40","74.07"
"624","Jakub Vrana","WSH","L","82","1031.3333333333","22","18","11","7","40","67.80"
"705","Sebastian Aho","CAR","C, R","82","1209.2333333333","14","26","16","10","40","63.49"
"61","Alexander Radulov","DAL","R","70","1098.7833333333","17","22","13","9","39","65.00"
"241","Evander Kane","S.J","L","75","1091.0166666667","21","18","10","8","39","63.93"
"362","Ryan Dzingel","CBJ, OTT","C, L","78","1120.3","20","19","10","9","39","66.10"
"377","Andrew Shaw","MTL","R","63","805.93333333333","16","23","14","9","39","70.91"
"412","Mika Zibanejad","NYR","C","82","1183.2833333333","14","25","17","8","39","78.00"
"428","Phillip Danault","MTL","C","81","1137.2166666667","10","29","17","12","39","61.90"
"635","David Pastrnak","BOS","R","66","947.76666666667","20","19","11","8","39","73.58"
"713","Mathew Barzal","NYI","C","82","1145.7833333333","14","25","14","11","39","82.98"
"845","Elias Pettersson","VAN","C","71","971.58333333333","14","25","19","6","39","82.98"
"190","Josh Bailey","NYI","R","82","1111.3","12","26","18","8","38","74.51"
"576","Elias Lindholm","CGY","C","81","1102.0333333333","13","25","10","15","38","61.29"
"708","Travis Konecny","PHI","C, R","82","1079.0333333333","18","20","12","8","38","73.08"
"168","Mikael Backlund","CGY","C","77","1086.2166666667","16","21","15","6","37","64.91"
"251","Chris Kreider","NYR","L","79","1083.4","19","18","6","12","37","62.71"
"319","Vladimir Tarasenko","STL","R","76","1084.2833333333","19","18","8","10","37","74.00"
"404","William Karlsson","VGK","C","82","1153.0666666667","15","22","13","9","37","67.27"
"432","Jonathan Marchessault","VGK","C","82","1198.9833333333","15","22","11","11","37","62.71"
"569","Tyler Bertuzzi","DET","L","73","1036.1166666667","15","22","8","14","37","72.55"
"709","Dylan Strome","ARI, CHI","C","78","982.61666666667","12","25","14","11","37","64.91"
"45","Patrice Bergeron","BOS","C","65","803.53333333333","14","22","13","9","36","72.00"
"52","Joe Pavelski","S.J","C","75","1073.8333333333","21","15","10","5","36","76.60"
"139","Jamie Benn","DAL","L","78","1107.15","18","18","10","8","36","69.23"
"171","Jakub Voracek","PHI","R","78","1111.45","12","24","14","10","36","75.00"
"312","Brock Nelson","NYI","C","82","1131.4833333333","19","17","9","8","36","78.26"
"317","Kevin Hayes","NYR, WPG","C, R","71","949.68333333333","10","26","16","10","36","80.00"
"408","Gabriel Landeskog","COL","L","73","1147.9166666667","17","19","14","5","36","62.07"
"524","Andreas Johnsson","TOR","L","73","866.01666666667","16","20","12","8","36","69.23"
"242","Brayden Schenn","STL","C","72","1045.0166666667","10","25","15","10","35","66.04"
"334","Nino Niederreiter","CAR, MIN","R","82","1095.4","17","18","8","10","35","67.31"
"499","Erik Gustafsson","CHI","D","79","1456.0666666667","9","26","12","14","35","47.95"
"688","Kyle Connor","WPG","L","82","1164.7666666667","18","17","12","5","35","61.40"
"8","Justin Williams","CAR","R","82","1151.1","12","22","13","9","34","68.00"
"36","Zach Parise","MIN","L","74","1007.5166666667","15","19","7","12","34","72.34"
"81","Anze Kopitar","L.A","C","81","1319.4166666667","17","17","12","5","34","65.38"
"169","Ryan McDonagh","T.B","D","82","1401.6666666667","7","27","12","15","34","41.98"
"228","Tyler Johnson","T.B","C","80","1060.0333333333","23","11","5","6","34","53.13"
"407","Ryan Nugent-Hopkins","EDM","C","82","1163.5","15","19","8","11","34","70.83"
"442","Yanni Gourde","T.B","C","80","980.81666666667","14","20","13","7","34","65.38"
"494","Andreas Athanasiou","DET","C","76","1036.25","21","13","10","3","34","85.00"
"500","Josh Anderson","CBJ","R","82","1136.5166666667","20","14","7","7","34","54.84"
"633","Kasperi Kapanen","TOR","R","78","1075.3166666667","14","20","9","11","34","59.65"
"664","Viktor Arvidsson","NSH","L, R","58","808.65","25","9","4","5","34","70.83"
"725","Thomas Chabot","OTT","D","70","1376.8833333333","10","24","9","15","34","43.59"
"25","Duncan Keith","CHI","D","82","1530.5333333333","5","28","10","18","33","39.76"
"84","T.J. Oshie","WSH","R","69","937.7","15","18","9","9","33","67.35"
"198","John Carlson","WSH","D","80","1358.2333333333","8","25","14","11","33","35.87"
"200","Roman Josi","NSH","D","82","1495.7666666667","9","24","11","13","33","50.00"
"270","Cody Eakin","VGK","C","78","971.9","17","16","12","4","33","68.75"
"325","Zach Hyman","TOR","C, L","71","1007.65","14","19","10","9","33","55.00"
"574","Jonathan Drouin","MTL","C, L","81","1068.0833333333","11","22","18","4","33","66.00"
"580","Bo Horvat","VAN","C","82","1285.0333333333","15","18","9","9","33","66.00"
"673","Kevin Labanc","S.J","R","82","932.43333333333","13","20","10","10","33","71.74"
"892","Dominik Kahun","CHI","C","82","1040.95","11","22","16","6","33","64.71"
"28","Eric Staal","MIN","C","81","1146.0166666667","14","18","11","7","32","66.67"
"38","Ryan Getzlaf","ANA","C","67","1009.25","11","21","11","10","32","78.05"
"91","Kris Letang","PIT","D","65","1252.2166666667","10","22","13","9","32","43.24"
"254","Reilly Smith","VGK","R","74","1002.9333333333","13","19","12","7","32","66.67"
"338","Joonas Donskoi","S.J","R","80","1008.9166666667","13","19","10","9","32","61.54"
"397","Brandon Saad","CHI","L","80","1099.9166666667","14","18","12","6","32","66.67"
"466","Filip Forsberg","NSH","L","64","877.41666666667","15","17","12","5","32","65.31"
"480","Chris Tierney","OTT","C","81","1067.7333333333","6","26","13","13","32","71.11"
"541","Oliver Bjorkstrand","CBJ","R","77","844.43333333333","19","13","12","1","32","78.05"
"690","Colin White","OTT","C","71","948.45","8","24","12","12","32","78.05"
"712","Brock Boeser","VAN","R","69","1001.0166666667","16","16","9","7","32","68.09"
"880","Brady Tkachuk","OTT","L","71","948.2","17","15","11","4","32","68.09"
"3","Joe Thornton","S.J","C","73","953.53333333333","10","21","14","7","31","64.58"
"34","Dustin Brown","L.A","R","72","1090.7666666667","10","21","13","8","31","72.09"
"65","Carl Soderberg","COL","C","82","1024.35","15","16","9","7","31","68.89"
"278","Anders Lee","NYI","L","82","1114.8166666667","15","16","10","6","31","57.41"
"394","Boone Jenner","CBJ","C","77","1048.9166666667","12","19","16","3","31","64.58"
"567","Artturi Lehkonen","MTL","L","82","999.65","11","20","13","7","31","63.27"
"62","Travis Zajac","N.J","C","80","1057.15","12","18","5","13","30","73.17"
"77","Paul Stastny","VGK","C","50","714.38333333333","10","20","14","6","30","78.95"
"108","Nick Foligno","CBJ","L","73","994.95","15","15","5","10","30","58.82"
"220","Jared Spurgeon","MIN","D","82","1494.9","10","20","9","11","30","48.39"
"256","Tyson Barrie","COL","D","78","1314.5333333333","11","19","11","8","30","50.00"
"265","Craig Smith","NSH","R","76","923.05","17","13","9","4","30","69.77"
"128","Artem Anisimov","CHI","C","78","1035.5833333333","13","16","9","7","29","72.50"
"161","David Perron","STL","L","57","795.71666666667","14","15","9","6","29","80.56"
"170","Max Pacioretty","VGK","L","66","899.63333333333","16","13","8","5","29","80.56"
"172","Jake Muzzin","L.A, TOR","D","80","1421.0833333333","8","21","9","12","29","45.31"
"244","Nazem Kadri","TOR","C","73","944.96666666667","11","18","11","7","29","78.38"
"321","Jaden Schwartz","STL","L","69","984.95","7","22","15","7","29","74.36"
"460","Tom Wilson","WSH","R","63","854.45","15","14","7","7","29","60.42"
"504","Vinnie Hinostroza","ARI","C","72","950.91666666667","11","18","10","8","29","90.63"
"884","Jesperi Kotkaniemi","MTL","C","79","910.96666666667","10","19","12","7","29","78.38"
"17","Jason Pominville","BUF","R","73","837.1","15","13","7","6","28","68.29"
"118","Jeff Petry","MTL","D","82","1425.9166666667","6","22","12","10","28","38.36"
"227","Antoine Roussel","VAN","L","65","817.83333333333","8","20","16","4","28","80.00"
"230","Mike Hoffman","FLA","L","82","1090.25","15","13","7","6","28","73.68"
"233","Kyle Palmieri","N.J","R","74","1011.3666666667","16","12","7","5","28","59.57"
"261","Richard Panik","ARI","R","75","973.3","11","17","11","6","28","63.64"
"333","Mikael Granlund","MIN, NSH","C, R","79","1119.6333333333","10","18","13","5","28","71.79"
"479","Jimmy Vesey","NYR","L","81","1017.05","13","15","12","3","28","70.00"
"842","Nico Hischier","N.J","C","69","936.78333333333","11","17","7","10","28","62.22"
"105","Bryan Little","WPG","C","82","1025.0166666667","8","19","11","8","27","67.50"
"127","Michael Frolik","CGY","R","65","812.5","12","15","9","6","27","61.36"
"136","Alex Killorn","T.B","L","82","916.18333333333","12","15","11","4","27","60.00"
"148","James van Riemsdyk","PHI","L","66","866.85","14","13","4","9","27","75.00"
"175","Lars Eller","WSH","C","81","983.38333333333","10","17","11","6","27","58.70"
"189","Mikkel Boedker","OTT","L","71","839.1","5","22","12","10","27","69.23"
"246","Ryan Ellis","NSH","D","82","1485.95","4","23","9","14","27","40.30"
"262","Mattias Ekholm","NSH","D","80","1504.2333333333","4","23","11","12","27","41.54"
"337","Bryan Rust","PIT","R","72","955.5","15","12","7","5","27","60.00"
"340","Marcus Sorensen","S.J","L","80","920.76666666667","15","12","6","6","27","60.00"
"471","Oskar Sundqvist","STL","C","74","842.33333333333","12","15","9","6","27","81.82"
"578","Darnell Nurse","EDM","D","82","1556.3833333333","8","19","9","10","27","42.86"
"620","Nikolaj Ehlers","WPG","L","62","862.05","16","11","5","6","27","72.97"
"622","Kevin Fiala","MIN, NSH","L","83","1073.2666666667","10","17","14","3","27","72.97"
"669","Oskar Lindblom","PHI","L","81","938.48333333333","13","14","11","3","27","71.05"
"19","Valtteri Filppula","NYI","C","72","807.86666666667","14","12","8","4","26","76.47"
"142","Nick Bonino","NSH","C","81","972.81666666667","13","13","8","5","26","59.09"
"231","Tyler Bozak","STL","C","72","857.98333333333","9","17","6","11","26","74.29"
"298","Jason Zucker","MIN","L","81","1137.6","12","14","9","5","26","66.67"
"307","Charlie Coyle","BOS, MIN","C","81","1076.0666666667","10","16","8","8","26","60.47"
"415","Dougie Hamilton","CAR","D","82","1361.1833333333","14","12","6","6","26","43.33"
"591","Anthony Mantha","DET","R","67","973.46666666667","13","13","8","5","26","68.42"
"600","Conor Sheary","BUF","L","78","951.23333333333","8","18","8","10","26","76.47"
"628","Travis Sanheim","PHI","D","82","1409.1","6","20","12","8","26","38.81"
"665","Danton Heinen","BOS","C","77","948.83333333333","10","16","12","4","26","70.27"
"694","Vince Dunn","STL","D","78","1144.6166666667","8","18","10","8","26","49.06"
"735","Jake DeBrusk","BOS","L","68","861.11666666667","17","9","6","3","26","68.42"
"740","Anthony Cirelli","T.B","C","82","920.66666666667","11","15","9","6","26","57.78"
"21","Frans Nielsen","DET","C","72","880.78333333333","10","15","4","11","25","64.10"
"46","Shea Weber","MTL","D","58","997.13333333333","9","16","7","9","25","58.14"
"205","Derek Stepan","ARI","C","72","975.05","9","16","12","4","25","71.43"
"237","Jakob Silfverberg","ANA","R","73","911.86666666667","16","9","5","4","25","86.21"
"267","Casey Cizikas","NYI","C","73","825.88333333333","15","10","7","3","25","78.13"
"351","Micheal Ferland","CAR","L","71","831.81666666667","10","15","13","2","25","59.52"
"382","Blake Coleman","N.J","C","78","1021.0333333333","13","12","7","5","25","60.98"
"453","Scott Laughton","PHI","C","82","991.18333333333","9","16","9","7","25","62.50"
"483","Damon Severson","N.J","D","82","1412.8833333333","8","17","12","5","25","42.37"
"539","Anthony Duclair","CBJ, OTT","L","74","803.55","12","13","5","8","25","67.57"
"684","Frank Vatrano","FLA","C","81","1023.3833333333","18","7","2","5","25","73.53"
"719","Zach Werenski","CBJ","D","82","1492.7","8","17","10","7","25","36.76"
"721","Anthony Beauvillier","NYI","C, L","81","1011.7333333333","17","8","4","4","25","59.52"
"755","Dominik Simon","PIT","C","71","871.96666666667","7","18","12","6","25","65.79"
"808","Mikhail Sergachev","T.B","D","75","1174.7333333333","5","20","12","8","25","40.98"
"835","Nolan Patrick","PHI","C","72","921.4","10","15","5","10","25","73.53"
"859","Alex Iafallo","L.A","L","82","1176.9","11","14","8","6","25","58.14"
"30","Ryan Suter","MIN","D","82","1642.7166666667","3","21","8","13","24","35.82"
"79","Bobby Ryan","OTT","R","78","997.13333333333","7","17","11","6","24","61.54"
"101","Patric Hornqvist","PIT","R","69","851.15","11","13","6","7","24","64.86"
"112","Leo Komarov","NYI","C, R","82","966.15","4","20","11","9","24","58.54"
"196","Jordan Eberle","NYI","C, R","78","1020.6666666667","12","12","8","4","24","58.54"
"209","Adam Henrique","ANA","C","82","1008.7833333333","10","14","8","6","24","64.86"
"257","Dmitry Orlov","WSH","D","82","1518.8166666667","3","21","10","11","24","36.36"
"363","Ondrej Palat","T.B","L","64","789.35","5","19","6","13","24","64.86"
"420","J.T. Miller","T.B","C","75","877.8","9","15","4","11","24","54.55"
"443","Ryan Murray","CBJ","D","56","982.18333333333","0","24","10","14","24","41.38"
"548","Andre Burakovsky","WSH","L","76","816.8","11","13","8","5","24","68.57"
"552","Ryan Hartman","NSH, PHI","R","83","1007.3833333333","11","13","5","8","24","53.33"
"575","Seth Jones","CBJ","D","75","1493.4","5","19","8","11","24","34.78"
"649","Brandon Montour","ANA, BUF","D","82","1473.2333333333","6","18","7","11","24","45.28"
"686","Noah Hanifin","CGY","D","80","1367.9166666667","3","21","7","14","24","38.71"
"726","Mathieu Joseph","T.B","R","70","715.6","13","11","8","3","24","66.67"
"747","Derek Ryan","CGY","C","81","792.75","10","14","8","6","24","70.59"
"773","Brandon Tanev","WPG","L","80","940.31666666667","11","13","9","4","24","80.00"
"785","Patrik Laine","WPG","R","82","1066.5","13","11","10","1","24","55.81"
"885","Andrei Svechnikov","CAR","R","82","1004.9666666667","13","11","3","8","24","64.86"
"132","Mathieu Perreault","WPG","C, L","82","878.18333333333","11","12","3","9","23","67.65"
"192","Erik Karlsson","S.J","D","53","977.16666666667","1","22","10","12","23","41.82"
"248","Zack Kassian","EDM","R","79","1048.7333333333","12","11","7","4","23","48.94"
"293","Mats Zuccarello","DAL, NYR","C, R","48","687.43333333333","9","14","12","2","23","71.88"
"464","Jacob Trouba","WPG","D","82","1434.2166666667","3","20","8","12","23","33.82"
"634","Jared McCann","FLA, PIT","C","78","935.18333333333","9","14","10","4","23","63.89"
"643","Ivan Barbashev","STL","C","80","776.88333333333","11","12","8","4","23","88.46"
"697","Jordan Greenway","MIN","L","81","1028.2333333333","11","12","7","5","23","74.19"
"786","Clayton Keller","ARI","C","82","1111.6666666667","13","10","7","3","23","60.53"
"807","Jesper Bratt","N.J","L","51","618.26666666667","6","17","12","5","23","82.14"
"846","Robert Thomas","STL","C","70","787.06666666667","5","18","11","7","23","76.67"
"4","Patrick Marleau","TOR","C","82","1142.7833333333","11","11","8","3","22","44.00"
"29","Thomas Vanek","DET","L","64","706.16666666667","10","12","7","5","22","78.57"
"44","Loui Eriksson","VAN","L","81","922.15","8","14","5","9","22","78.57"
"149","Paul Byron","MTL","L","56","649.83333333333","11","11","7","4","22","66.67"
"180","Zack Smith","OTT","L","70","981.25","7","15","9","6","22","70.97"
"212","TJ Brodie","CGY","D","79","1393.2166666667","4","18","11","7","22","32.35"
"268","David Savard","CBJ","D","82","1430.75","7","15","7","8","22","31.88"
"299","Tyler Toffoli","L.A","R","82","1073.65","6","16","9","7","22","62.86"
"430","Rickard Rakell","ANA","C, L","69","1012.4833333333","9","13","10","3","22","61.11"
"454","Mark Jankowski","CGY","C","79","809.06666666667","8","14","8","6","22","81.48"
"467","Radek Faksa","DAL","C","81","1085.85","10","12","9","3","22","66.67"
"485","Colton Sissons","NSH","C","75","917.66666666667","10","12","7","5","22","57.89"
"507","Connor Brown","TOR","R","82","935.93333333333","6","16","11","5","22","64.71"
"509","Alexander Kerfoot","COL","C","78","955.01666666667","9","13","9","4","22","68.75"
"536","Pavel Buchnevich","NYR","R","64","804.63333333333","11","11","7","4","22","68.75"
"545","Andrew Copp","WPG","C","69","729.31666666667","9","13","7","6","22","62.86"
"586","Ryan Pulock","NYI","D","82","1435.8166666667","3","19","8","11","22","35.48"
"612","Aaron Ekblad","FLA","D","82","1495.5","7","15","6","9","22","27.85"
"822","Michal Kempny","WSH","D","71","1201.7833333333","6","16","6","10","22","31.43"
"850","Miro Heiskanen","DAL","D","82","1547.2666666667","8","14","6","8","22","37.93"
"886","Rasmus Dahlin","BUF","D","82","1406.3666666667","4","18","6","12","22","37.93"
"12","Ilya Kovalchuk","L.A","L","64","820.46666666667","9","12","8","4","21","80.77"
"31","Braydon Coburn","T.B","D","74","1097.2","3","18","7","11","21","42.00"
"88","Marc-Edouard Vlasic","S.J","D","72","1211.0833333333","3","18","11","7","21","39.62"
"120","Jordan Staal","CAR","C","50","678.93333333333","9","12","5","7","21","80.77"
"215","Matt Calvert","COL","L","82","943.65","9","12","8","4","21","60.00"
"239","Victor Hedman","T.B","D","70","1128.15","8","13","7","6","21","35.59"
"283","Nic Dowd","WSH","C","64","548.6","8","13","9","4","21","80.77"
"287","Brenden Dillon","S.J","D","82","1328.0333333333","0","21","11","10","21","31.82"
"311","Justin Faulk","CAR","D","82","1379.8166666667","4","17","12","5","21","36.21"
"327","Taylor Hall","N.J","L","33","496.65","7","14","11","3","21","75.00"
"380","Nick Cousins","ARI","C","81","995.05","6","15","7","8","21","61.76"
"459","Cody Ceci","OTT","D","74","1389.9166666667","6","15","11","4","21","38.18"
"476","Devin Shore","ANA, DAL","C","76","866.01666666667","6","15","10","5","21","70.00"
"481","Jordan Martinook","CAR","L","82","1024.9333333333","12","9","7","2","21","55.26"
"488","Brock McGinn","CAR","L","82","932.48333333333","7","14","6","8","21","61.76"
"538","Mattias Janmark","DAL","C","81","1042.85","6","15","11","4","21","80.77"
"549","Shea Theodore","VGK","D","79","1330.7833333333","6","15","8","7","21","44.68"
"579","Rasmus Ristolainen","BUF","D","78","1423.45","3","18","7","11","21","41.18"
"615","Sam Bennett","CGY","C","71","804.28333333333","9","12","10","2","21","61.76"
"619","William Nylander","TOR","R","54","708.81666666667","6","15","9","6","21","63.64"
"621","Nick Ritchie","ANA","L","60","744.65","6","15","10","5","21","61.76"
"639","Adrian Kempe","L.A","C","81","980.71666666667","10","11","5","6","21","72.41"
"717","Austin Wagner","L.A","L","62","546.63333333333","12","9","6","3","21","91.30"
"736","Ivan Provorov","PHI","D","82","1599.5166666667","7","14","3","11","21","31.34"
"742","Evan Rodrigues","BUF","L","74","903.95","7","14","11","3","21","58.33"
"780","Charlie McAvoy","BOS","D","54","974.7","5","16","10","6","21","39.62"
"791","Brett Howden","NYR","C","66","774.38333333333","6","15","11","4","21","67.74"
"796","Tyson Jost","COL","C","70","758.25","7","14","6","8","21","70.00"
"185","Alex Pietrangelo","STL","D","71","1278.9833333333","6","14","5","9","20","32.79"
"188","Colin Wilson","COL","C","65","732.35","7","13","2","11","20","74.07"
"194","Jake Gardiner","TOR","D","62","1135.95","3","17","10","7","20","33.90"
"226","Jordie Benn","MTL","D","81","1213.3333333333","3","17","6","11","20","33.33"
"236","Alex Chiasson","EDM","R","73","963.66666666667","12","8","7","1","20","62.50"
"441","Luke Glendening","DET","C","78","996.6","9","11","7","4","20","48.78"
"478","Adam Pelech","NYI","D","78","1265.5666666667","5","15","7","8","20","39.22"
"543","Miles Wood","N.J","L","63","767.63333333333","8","12","9","3","20","71.43"
"556","J.T. Compher","COL","L","66","769.88333333333","9","11","7","4","20","74.07"
"727","Lawson Crouse","ARI","L","81","917.53333333333","8","12","9","3","20","66.67"
"820","Drake Caggiula","CHI, EDM","C, L","55","715.28333333333","10","10","5","5","20","57.14"
"49","Brad Richardson","ARI","C","66","823.86666666667","14","5","4","1","19","65.52"
"73","Troy Brouwer","FLA","R","75","793","10","9","8","1","19","67.86"
"86","Matt Niskanen","WSH","D","80","1429.1333333333","6","13","6","7","19","35.85"
"109","Erik Johnson","COL","D","80","1398.8333333333","5","14","5","9","19","35.19"
"174","Carl Hagelin","L.A, PIT, WSH","L","58","722.98333333333","5","14","6","8","19","55.88"
"191","Tyler Myers","WPG","D","80","1304.4","7","12","6","6","19","35.85"
"235","Kyle Clifford","L.A","L","72","734.45","9","10","6","4","19","70.37"
"260","Brian Dumoulin","PIT","D","76","1334.6166666667","3","16","3","13","19","26.39"
"295","Oscar Lindberg","OTT, VGK","C, L","55","644.33333333333","9","10","8","2","19","61.29"
"315","Nick Bjugstad","FLA, PIT","C","64","834.85","11","8","0","8","19","65.52"
"350","John Klingberg","DAL","D","64","1257.15","4","15","5","10","19","41.30"
"359","Brian Gibbons","ANA, OTT","C, L","64","642.91666666667","8","11","8","3","19","67.86"
"401","Matt Nieto","COL","L","64","696.18333333333","3","16","10","6","19","70.37"
"411","Ryan Strome","EDM, NYR","C","81","1014.1","9","10","7","3","19","57.58"
"451","Brady Skjei","NYR","D","78","1372.9","6","13","8","5","19","35.19"
"452","Tanner Pearson","L.A, PIT, VAN","L","80","984.63333333333","15","4","3","1","19","67.86"
"470","Brendan Leipsic","L.A, VAN","L","62","727.7","6","13","10","3","19","76.00"
"472","Esa Lindell","DAL","D","82","1553.6333333333","4","15","6","9","19","37.25"
"493","Jaccob Slavin","CAR","D","82","1436.35","2","17","5","12","19","35.85"
"617","Jake Virtanen","VAN","R","70","897.86666666667","11","8","6","2","19","67.86"
"817","Troy Stecher","VAN","D","78","1320.6","1","18","9","9","19","38.00"
"24","Alexander Steen","STL","L","65","786.08333333333","7","11","5","6","18","60.00"
"63","Mike Green","DET","D","43","792.53333333333","4","14","5","9","18","54.55"
"64","Blake Comeau","DAL","L","77","1017.35","7","11","5","6","18","60.00"
"93","Keith Yandle","FLA","D","82","1411.9333333333","2","16","8","8","18","27.69"
"176","Wayne Simmonds","NSH, PHI","R","79","987.51666666667","10","8","7","1","18","58.06"
"243","Oliver Ekman-Larsson","ARI","D","81","1428.6333333333","5","13","8","5","18","38.30"
"276","Ben Chiarot","WPG","D","78","1281.4333333333","4","14","9","5","18","40.91"
"281","Nick Jensen","DET, WSH","D","80","1340.9333333333","2","16","9","7","18","32.14"
"294","Calle Jarnkrok","NSH","C","79","960.51666666667","7","11","3","8","18","45.00"
"343","Kenny Agostino","MTL, N.J","L","63","717.3","6","12","7","5","18","66.67"
"345","Jesper Fast","NYR","R","66","882.66666666667","8","10","3","7","18","60.00"
"369","Travis Boyd","WSH","C","53","473.83333333333","5","13","8","5","18","69.23"
"379","Adam Lowry","WPG","C","78","939.95","10","8","4","4","18","60.00"
"444","Alex Galchenyuk","ARI","C","72","856.56666666667","9","9","4","5","18","72.00"
"474","Shayne Gostisbehere","PHI","D","78","1182.45","4","14","5","9","18","42.86"
"519","Carter Rowney","ANA","C, R","62","649","5","13","8","5","18","94.74"
"551","Jason Dickinson","DAL","C","67","763.05","3","15","8","7","18","69.23"
"560","Robert Hagg","PHI","D","82","1215.6833333333","4","14","9","5","18","35.29"
"571","Brett Pesce","CAR","D","73","1240.3666666667","6","12","7","5","18","31.03"
"630","Tony DeAngelo","NYR","D","61","988.25","4","14","6","8","18","36.00"
"762","Markus Nutivaara","CBJ","D","80","1354.6","5","13","8","5","18","33.33"
"6","Ron Hainsey","TOR","D","81","1360.2666666667","3","14","5","9","17","22.67"
"99","Ryan Reaves","VGK","R","80","801.58333333333","6","11","7","4","17","65.38"
"110","Kyle Okposo","BUF","R","78","902.65","7","10","6","4","17","56.67"
"146","Kevin Shattenkirk","NYR","D","73","1120.8833333333","1","16","8","8","17","44.74"
"152","P.K. Subban","NSH","D","63","1109.5","6","11","8","3","17","36.17"
"289","Radko Gudas","PHI","D","77","1150.65","3","14","7","7","17","37.78"
"368","Josh Archibald","ARI","R","68","783.98333333333","9","8","4","4","17","58.62"
"370","Dylan DeMelo","OTT","D","77","1273.7166666667","4","13","8","5","17","23.61"
"376","Sean Kuraly","BOS","C","71","857.45","5","12","7","5","17","73.91"
"385","Josh Leivo","TOR, VAN","L","76","857.36666666667","11","6","5","1","17","47.22"
"410","Adam Larsson","EDM","D","82","1548.7166666667","3","14","6","8","17","37.78"
"429","Vladislav Namestnikov","NYR","C","78","951.1","7","10","4","6","17","56.67"
"437","Torey Krug","BOS","D","64","1039.7166666667","3","14","7","7","17","39.53"
"448","Pontus Aberg","ANA, MIN","L","59","717.83333333333","9","8","5","3","17","68.00"
"456","Mike Matheson","FLA","D","75","1360.75","6","11","5","6","17","30.91"
"517","Danny DeKeyser","DET","D","52","944.65","4","13","10","3","17","39.53"
"554","Adam Erne","T.B","L","65","629.38333333333","5","12","5","7","17","60.71"
"570","Zach Sanford","STL","L","60","703.01666666667","8","9","5","4","17","62.96"
"607","Garnet Hathaway","CGY","R","76","649.26666666667","9","8","2","6","17","62.96"
"641","Brendan Lemieux","NYR, WPG","L","63","544.86666666667","12","5","2","3","17","65.38"
"659","Lucas Wallmark","CAR","C","81","989.81666666667","7","10","5","5","17","58.62"
"707","Christian Fischer","ARI","R","71","797.81666666667","11","6","3","3","17","77.27"
"718","Jack Roslovic","WPG","C","77","689.95","4","13","9","4","17","62.96"
"723","Daniel Sprong","ANA, PIT","R","63","659.35","11","6","5","1","17","77.27"
"803","Samuel Girard","COL","D","82","1393.6666666667","4","13","7","6","17","28.81"
"861","David Kampf","CHI","C","63","734.11666666667","4","13","9","4","17","73.91"
"147","Pat Maroon","STL","L","74","890.7","8","8","4","4","16","45.71"
"183","Drew Doughty","L.A","D","82","1632.35","0","16","11","5","16","34.04"
"186","Zach Bogosian","BUF","D","65","1157.25","2","14","6","8","16","32.00"
"232","Marcus Johansson","BOS, N.J","L","58","728.53333333333","9","7","3","4","16","61.54"
"322","Riley Sheahan","FLA, PIT","C","82","912.86666666667","7","9","4","5","16","59.26"
"323","Chris Wagner","BOS","R","76","896.83333333333","10","6","4","2","16","57.14"
"378","Vincent Trocheck","FLA","C","55","784.51666666667","5","11","6","5","16","55.17"
"392","Scott Mayfield","NYI","D","79","1260.3","3","13","5","8","16","34.78"
"405","Scott Harrington","CBJ","D","73","878.96666666667","2","14","6","8","16","45.71"
"446","Hampus Lindholm","ANA","D","76","1419.5833333333","1","15","3","12","16","29.09"
"458","Zemgus Girgensons","BUF","C","72","786.63333333333","5","11","5","6","16","69.57"
"584","Josh Morrissey","WPG","D","59","989.85","1","15","6","9","16","34.04"
"623","Brendan Perlini","ARI, CHI","L","68","724.38333333333","11","5","2","3","16","69.57"
"637","Nikolay Goldobin","VAN","R","63","743.1","6","10","3","7","16","55.17"
"644","Marcus Pettersson","ANA, PIT","D","84","1220.4","1","15","8","7","16","32.65"
"776","Luke Kunin","MIN","C","49","622.48333333333","6","10","8","2","16","57.14"
"1","Matt Cullen","PIT","C","71","640.21666666667","5","10","7","3","15","60.00"
"22","Jay Bouwmeester","STL","D","78","1398.0166666667","3","12","8","4","15","35.71"
"23","Johnny Boychuk","NYI","D","74","1196.85","2","13","6","7","15","30.61"
"33","Jeff Carter","L.A","C","76","1033.7833333333","7","8","6","2","15","51.72"
"35","Brent Seabrook","CHI","D","78","1159.5333333333","3","12","6","6","15","32.61"
"67","Alex Goligoski","ARI","D","76","1259.6333333333","1","14","6","8","15","32.61"
"85","Andrew Cogliano","ANA, DAL","C, L","78","859.25","5","10","7","3","15","71.43"
"100","Anton Stralman","T.B","D","47","795.48333333333","2","13","5","8","15","37.50"
"106","Alex Biega","VAN","D","41","679.16666666667","2","13","6","7","15","50.00"
"115","Milan Lucic","EDM","L","79","924.06666666667","4","11","9","2","15","55.56"
"117","Cal Clutterbuck","NYI","R","73","757.65","3","12","8","4","15","60.00"
"145","Justin Braun","S.J","D","78","1347.1","2","13","6","7","15","39.47"
"204","Travis Hamonic","CGY","D","69","1183.65","6","9","5","4","15","24.19"
"245","Magnus Paajarvi","OTT","L","80","898.01666666667","8","7","1","6","15","62.50"
"250","Nick Leddy","NYI","D","82","1418.85","4","11","8","3","15","24.19"
"263","Marcus Foligno","MIN","L","82","818.93333333333","7","8","4","4","15","62.50"
"399","Markus Granlund","VAN","C","77","823.8","8","7","4","3","15","68.18"
"416","Jonas Brodin","MIN","D","82","1429.9166666667","3","12","6","6","15","35.71"
"469","Colton Parayko","STL","D","80","1512.6833333333","5","10","2","8","15","25.86"
"477","Jujhar Khaira","EDM","L","60","650","2","13","10","3","15","71.43"
"496","Brett Kulak","MTL","D","57","965.51666666667","5","10","3","7","15","29.41"
"498","Cedric Paquette","T.B","C","80","784.55","11","4","3","1","15","50.00"
"521","Michael Raffl","PHI","L","67","688.01666666667","4","11","5","6","15","57.69"
"540","Sven Andrighetto","COL","R","64","611.76666666667","6","9","6","3","15","62.50"
"585","Alexander Wennberg","CBJ","C","75","861.38333333333","0","15","9","6","15","46.88"
"611","Tomas Nosek","VGK","L","68","687.2","7","8","7","1","15","62.50"
"650","Ryan Donato","BOS, MIN","C","56","628.85","6","9","4","5","15","78.95"
"654","Warren Foegele","CAR","L","77","832.08333333333","10","5","3","2","15","60.00"
"677","Ondrej Kase","ANA","R","30","384.5","10","5","4","1","15","71.43"
"687","Rasmus Andersson","CGY","D","79","1095.3333333333","1","14","3","11","15","31.25"
"700","Erik Cernak","T.B","D","58","923.65","4","11","6","5","15","28.30"
"751","Denis Malgin","FLA","C","50","575.03333333333","7","8","5","3","15","71.43"
"831","Zach Aston-Reese","PIT","C","43","494.13333333333","6","9","3","6","15","68.18"
"840","Casey Mittelstadt","BUF","C","77","858.85","9","6","5","1","15","46.88"
"9","Niklas Kronwall","DET","D","79","1308.35","2","12","5","7","14","30.43"
"13","Jason Spezza","DAL","C","76","811.66666666667","6","8","2","6","14","66.67"
"71","Ryan Callahan","T.B","R","52","511.76666666667","5","9","7","2","14","63.64"
"89","Justin Abdelkader","DET","L","71","886.15","3","11","4","7","14","58.33"
"92","Kris Russell","EDM","D","72","1278.6833333333","3","11","4","7","14","28.00"
"103","Andy Greene","N.J","D","82","1320.2","3","11","6","5","14","28.57"
"122","Derick Brassard","COL, FLA, PIT","C","70","892.51666666667","9","5","3","2","14","58.33"
"247","Calvin de Haan","CAR","D","74","1180.5166666667","1","13","7","6","14","34.15"
"253","Brayden McNabb","VGK","D","81","1314.5833333333","3","11","7","4","14","22.95"
"309","Jon Merrill","VGK","D","57","924.38333333333","2","12","5","7","14","35.00"
"316","Derek Forbort","L.A","D","81","1458.6833333333","2","12","4","8","14","36.84"
"366","Josh Manson","ANA","D","74","1365.2833333333","3","11","9","2","14","31.82"
"526","MacKenzie Weegar","FLA","D","64","951.35","4","10","4","6","14","40.00"
"528","Will Butcher","N.J","D","78","1223.5333333333","3","11","2","9","14","26.92"
"587","Nikita Zadorov","COL","D","70","1052.9833333333","7","7","6","1","14","29.79"
"592","Frederik Gauthier","TOR","C","70","569.05","3","11","5","6","14","58.33"
"601","Trevor van Riemsdyk","CAR","D","78","1067.8166666667","3","11","5","6","14","38.89"
"691","Pavel Zacha","N.J","C","61","708.3","7","7","3","4","14","53.85"
"695","Travis Dermott","TOR","D","64","1004.2833333333","4","10","3","7","14","32.56"
"733","Joel Eriksson Ek","MIN","C","58","675.83333333333","7","7","7","0","14","56.00"
"739","Austin Czarnik","CGY","C","54","525.95","5","9","5","4","14","63.64"
"746","Noel Acciari","BOS","C","72","812.53333333333","6","8","5","3","14","66.67"
"815","Filip Hronek","DET","D","46","751.41666666667","4","10","3","7","14","56.00"
"856","Filip Chytil","NYR","C","75","897.41666666667","6","8","7","1","14","63.64"
"14","Mikko Koivu","MIN","C","48","642.7","4","9","8","1","13","61.90"
"82","Marc Staal","NYR","D","79","1260.4166666667","3","10","3","7","13","28.26"
"87","James Neal","CGY","L","63","784.55","5","8","6","2","13","50.00"
"98","Darren Helm","DET","L","61","751.31666666667","6","7","7","0","13","56.52"
"156","Kyle Turris","NSH","C","55","706.26666666667","2","11","10","1","13","61.90"
"160","Colton Sceviour","FLA","C","59","584.01666666667","4","9","8","1","13","56.52"
"173","Alec Martinez","L.A","D","60","1053.35","4","9","3","6","13","28.89"
"177","Nick Holden","VGK","D","61","973.6","3","10","5","5","13","30.95"
"197","Tyler Ennis","TOR","C, L","51","422.51666666667","10","3","2","1","13","86.67"
"214","Derek Grant","ANA, PIT","C","56","549.55","4","9","5","4","13","61.90"
"218","Matt Martin","NYI","L","67","737.23333333333","5","8","3","5","13","56.52"
"301","Johan Larsson","BUF","C","73","850.9","5","8","4","4","13","50.00"
"391","Rocco Grimaldi","NSH","C","53","523.91666666667","5","8","4","4","13","92.86"
"421","Joel Armia","MTL","R","57","686.76666666667","7","6","5","1","13","56.52"
"424","Connor Murphy","CHI","D","52","884.53333333333","5","8","2","6","13","31.71"
"431","Colin Miller","VGK","D","65","1034.3333333333","1","12","6","6","13","30.95"
"435","Barclay Goodrow","S.J","R","82","768.46666666667","6","7","1","6","13","50.00"
"503","Matthew Benning","EDM","D","70","902.13333333333","3","10","5","5","13","30.23"
"518","Nate Schmidt","VGK","D","61","1084.7833333333","4","9","3","6","13","22.81"
"602","Ryan Carpenter","VGK","C","68","736.9","3","10","3","7","13","52.00"
"609","Melker Karlsson","S.J","C","79","773.3","9","4","1","3","13","59.09"
"663","Devon Toews","NYI","D","48","741.83333333333","3","10","6","4","13","46.43"
"681","Andrew Mangiapane","CGY","L","44","434.68333333333","8","5","3","2","13","59.09"
"714","Roope Hintz","DAL","L","58","659.75","5","8","5","3","13","68.42"
"890","Par Lindholm","TOR, WPG","C","65","624.03333333333","1","12","7","5","13","54.17"
"47","David Backes","BOS","R","70","765.21666666667","5","7","3","4","12","57.14"
"70","Alexander Edler","VAN","D","56","984.18333333333","4","8","4","4","12","34.29"
"102","Dan Girardi","T.B","D","62","940.9","3","9","1","8","12","25.53"
"111","Trevor Lewis","L.A","C","44","537.08333333333","3","9","6","3","12","66.67"
"143","Ian Cole","COL","D","71","1132.3","1","11","2","9","12","31.58"
"206","Marco Scandella","BUF","D","63","950.95","6","6","1","5","12","36.36"
"258","Brandon Pirri","VGK","C","31","376.66666666667","9","3","3","0","12","57.14"
"305","Jordan Weal","ARI, MTL, PHI","C","63","763.26666666667","4","8","5","3","12","52.17"
"318","Cam Fowler","ANA","D","59","1093.4166666667","2","10","5","5","12","33.33"
"320","Austin Watson","NSH","L","37","452.28333333333","4","8","5","3","12","60.00"
"387","Jean-Gabriel Pageau","OTT","C","39","557.7","4","8","5","3","12","85.71"
"419","Jamie Oleksiak","DAL, PIT","D","57","807.11666666667","4","8","3","5","12","33.33"
"423","Oscar Klefbom","EDM","D","61","1132.0333333333","1","11","3","8","12","40.00"
"487","Jake McCabe","BUF","D","59","964.66666666667","3","9","3","6","12","36.36"
"527","Tyler Motte","VAN","C","74","801.05","6","6","3","3","12","57.14"
"604","Jordan Oesterle","ARI","D","71","1096.2166666667","3","9","4","5","12","30.00"
"754","Conor Garland","ARI","R","47","473.23333333333","9","3","0","3","12","75.00"
"760","Brett Seney","N.J","L","51","511.91666666667","5","7","5","2","12","75.00"
"819","Nikita Zaitsev","TOR","D","81","1375.75","3","9","1","8","12","23.08"
"41","Brian Boyle","N.J, NSH","C","73","648.13333333333","9","2","2","0","11","44.00"
"54","Dustin Byfuglien","WPG","D","42","767.33333333333","2","9","3","6","11","37.93"
"60","Drew Stafford","N.J","R","57","636.85","4","7","5","2","11","61.11"
"150","Sam Gagner","EDM, VAN","C","32","407.68333333333","4","7","5","2","11","73.33"
"158","Brendan Smith","NYR","D","63","842.38333333333","4","7","4","3","11","50.00"
"264","Sami Vatanen","N.J","D","50","832.23333333333","1","10","7","3","11","33.33"
"280","Marcus Kruger","CHI","C","74","624.95","4","7","3","4","11","52.38"
"303","Greg McKegg","CAR","C","41","422.81666666667","6","5","4","1","11","68.75"
"335","Joakim Nordstrom","BOS","C","70","792.53333333333","6","5","3","2","11","44.00"
"422","Nathan Beaulieu","BUF, WPG","D","48","694.98333333333","3","8","3","5","11","31.43"
"463","Derrick Pouliot","VAN","D","62","947.33333333333","2","9","4","5","11","24.44"
"610","Pierre-Edouard Bellemare","VGK","C, L","76","775.28333333333","4","7","5","2","11","47.83"
"631","Nick Schmaltz","ARI, CHI","C","40","535.78333333333","1","10","6","4","11","64.71"
"642","Jayce Hawryluk","FLA","C","42","389.91666666667","7","4","1","3","11","73.33"
"658","Michael Amadio","L.A","C","43","405.85","6","5","1","4","11","57.89"
"788","Jakob Chychrun","ARI","D","53","898.18333333333","2","9","3","6","11","42.31"
"806","Henrik Borgstrom","FLA","C","50","529.76666666667","5","6","1","5","11","55.00"
"838","Michael Rasmussen","DET","C","62","623.95","2","9","5","4","11","61.11"
"873","Kiefer Sherwood","ANA","R","50","544.73333333333","6","5","1","4","11","57.89"
"2","Zdeno Chara","BOS","D","62","1087.4666666667","4","6","2","4","10","19.61"
"27","Chris Kunitz","CHI","L","56","487.63333333333","5","5","3","2","10","66.67"
"51","Nate Thompson","L.A, MTL","C","78","832.3","4","6","1","5","10","41.67"
"58","Andrew Ladd","NYI","L","26","326.18333333333","3","7","2","5","10","76.92"
"94","Vladimir Sobotka","BUF","C","69","805.18333333333","3","7","4","3","10","55.56"
"154","Riley Nash","CBJ","C","78","805.71666666667","2","8","6","2","10","62.50"
"181","Jay Beagle","VAN","C","57","611.23333333333","1","9","6","3","10","58.82"
"341","Tim Heed","S.J","D","37","466.86666666667","1","9","5","4","10","34.48"
"388","Mike Reilly","MTL","D","57","923.58333333333","2","8","2","6","10","23.26"
"390","Ty Rattie","EDM","R","50","515.13333333333","4","6","5","1","10","62.50"
"400","Joel Edmundson","STL","D","64","1053.6833333333","2","8","7","1","10","22.73"
"447","Matt Dumba","MIN","D","32","577.46666666667","6","4","2","2","10","41.67"
"455","Olli Maatta","PIT","D","60","927.25","0","10","7","3","10","23.26"
"473","Chandler Stephenson","WSH","C","64","655.46666666667","4","6","4","2","10","71.43"
"489","Connor Carrick","DAL, N.J","D","34","513.9","2","8","4","4","10","62.50"
"511","Christian Djoos","WSH","D","45","598.98333333333","1","9","5","4","10","35.71"
"516","Tim Schaller","VAN","C","47","434.46666666667","3","7","6","1","10","58.82"
"566","Madison Bowey","DET, WSH","D","50","700.71666666667","2","8","4","4","10","38.46"
"759","Adam Gaudette","VAN","C","56","530.21666666667","5","5","3","2","10","58.82"
"761","Mason Appleton","WPG","C","36","282.9","3","7","5","2","10","58.82"
"799","Victor Mete","MTL","D","71","1136.5333333333","0","10","4","6","10","20.00"
"813","Tage Thompson","BUF","C, R","65","715.98333333333","6","4","4","0","10","71.43"
"878","Lukas Radil","S.J","C","36","380.05","6","4","3","1","10","58.82"
"7","Brooks Orpik","WSH","D","53","668.15","2","7","2","5","9","24.32"
"11","Deryk Engelland","VGK","D","74","1200.6833333333","2","7","4","3","9","20.93"
"135","Ben Lovejoy","DAL, N.J","D","71","947.7","2","7","3","4","9","28.13"
"166","Robert Bortuzzo","STL","D","59","760.2","2","7","5","2","9","24.32"
"195","Michael Del Zotto","ANA, STL, VAN","D","42","629.85","1","8","2","6","9","36.00"
"201","Justin Schultz","PIT","D","29","490.85","1","8","3","5","9","47.37"
"211","Dale Weise","MTL, PHI","R","51","520.35","4","5","2","3","9","69.23"
"252","John Moore","BOS","D","61","947.33333333333","1","8","4","4","9","31.03"
"326","Erik Gudbranson","PIT, VAN","D","76","1194.45","2","7","3","4","9","22.50"
"332","Mark Pysyk","FLA","D","70","1127.3333333333","1","8","3","5","9","19.57"
"372","Tobias Rieder","EDM","R","67","716.88333333333","0","9","6","3","9","90.00"
"508","Ben Hutton","VAN","D","69","1198.4166666667","3","6","0","6","9","23.68"
"555","Jacob de la Rose","DET","C, L","60","587.53333333333","3","6","3","3","9","52.94"
"568","William Carrier","VGK","L","54","528.65","8","1","1","0","9","64.29"
"581","Valeri Nichushkin","DAL","R","57","629.88333333333","0","9","3","6","9","50.00"
"589","Mirco Mueller","N.J","D","53","845.1","1","8","4","4","9","36.00"
"680","Dryden Hunt","FLA","L","31","337.76666666667","2","7","3","4","9","64.29"
"757","Rudolfs Balcers","OTT","L","36","377.75","2","7","2","5","9","90.00"
"772","Kevin Rooney","N.J","C","41","429.83333333333","5","4","1","3","9","60.00"
"827","Matt Luff","L.A","R","33","348.05","6","3","2","1","9","69.23"
"862","Neal Pionk","NYR","D","73","1163.35","2","7","1","6","9","23.68"
"37","Eric Fehr","MIN","C","72","642.8","4","4","2","2","8","57.14"
"53","Kyle Brodziak","EDM","C","70","681.05","5","3","2","1","8","53.33"
"66","Brandon Dubinsky","CBJ","C","61","652.38333333333","4","4","3","1","8","66.67"
"72","Roman Polak","DAL","D","77","1236.2333333333","1","7","3","4","8","20.51"
"163","Mario Kempe","ARI","R","52","530.85","3","5","3","2","8","50.00"
"164","Yannick Weber","NSH","D","62","699.45","2","6","3","3","8","28.57"
"272","Garrett Wilson","PIT","L","50","350.35","2","6","4","2","8","66.67"
"292","Christopher Tanev","VAN","D","55","873.31666666667","1","7","4","3","8","28.57"
"300","Ryan Spooner","EDM, NYR, VAN","C","52","520.5","3","5","3","2","8","72.73"
"308","Patrik Nemeth","COL","D","74","962.31666666667","1","7","6","1","8","23.53"
"310","Tyler Pitlick","DAL","C","47","543.6","6","2","1","1","8","57.14"
"314","Devante Smith-Pelly","WSH","R","54","487.08333333333","4","4","3","1","8","57.14"
"355","Taylor Fedun","DAL","D","54","671.91666666667","4","4","3","1","8","42.11"
"361","Matthew Peca","MTL","C","39","355.23333333333","3","5","4","1","8","133.33"
"395","Dmitrij Jaskin","WSH","R","37","363.03333333333","2","6","1","5","8","61.54"
"468","Matt Grzelcyk","BOS","D","66","1063.3333333333","1","7","2","5","8","21.62"
"482","Boo Nieves","NYR","C","43","383.36666666667","4","4","1","3","8","72.73"
"529","Saku Maenalanen","CAR","R","34","303.56666666667","4","4","3","1","8","61.54"
"662","Christoffer Ehn","DET","C","60","582.56666666667","2","6","2","4","8","66.67"
"667","Gustav Forsling","CHI","D","43","656.85","2","6","2","4","8","50.00"
"706","Oliver Kylington","CGY","D","38","465.35","3","5","2","3","8","53.33"
"753","Christian Wolanin","OTT","D","30","443.08333333333","3","5","2","3","8","28.57"
"829","Trevor Moore","TOR","L","25","219.58333333333","2","6","2","4","8","88.89"
"865","Radim Simek","S.J","D","41","576.6","1","7","3","4","8","27.59"
"871","Sean Walker","L.A","D","39","576.36666666667","2","6","4","2","8","34.78"
"896","Bogdan Kiselevich","FLA","D","32","445.6","0","8","6","2","8","57.14"
"897","Antti Suomela","S.J","C","27","299.7","3","5","3","2","8","100.00"
"178","Jason Demers","ARI","D","35","593.71666666667","2","5","3","2","7","33.33"
"216","Greg Pateryn","MIN","D","80","1208.2","1","6","5","1","7","17.95"
"279","Phil Varone","PHI","C","47","366.88333333333","3","4","3","1","7","58.33"
"291","Matt Irwin","NSH","D","44","485.91666666667","1","6","4","2","7","35.00"
"339","Tom Kuhnhackl","NYI","R","36","406.68333333333","4","3","2","1","7","50.00"
"375","Nick Seeler","MIN","D","71","809.21666666667","2","5","2","3","7","25.93"
"396","Victor Rask","CAR, MIN","C","49","503.9","3","4","3","1","7","53.85"
"418","Sven Baertschi","VAN","L","26","305.21666666667","6","1","1","0","7","63.64"
"426","Joe Morrow","WPG","D","41","559.38333333333","1","6","4","2","7","25.00"
"439","J.T. Brown","MIN","R","56","498.35","2","5","3","2","7","43.75"
"486","Teddy Blueger","PIT","C","28","272.51666666667","5","2","1","1","7","70.00"
"512","Joakim Ryan","S.J","D","44","545.15","0","7","0","7","7","24.14"
"595","Colby Cave","BOS, EDM","C","53","562.96666666667","2","5","2","3","7","50.00"
"616","Michael Dal Colle","NYI","L","28","329.15","3","4","4","0","7","53.85"
"675","Dylan Sikura","CHI","R","33","369.96666666667","0","7","6","1","7","43.75"
"701","Jakob Forsbacka Karlsson","BOS","C","28","305.06666666667","2","5","3","2","7","77.78"
"711","Brandon Carlo","BOS","D","72","1256.15","2","5","3","2","7","14.89"
"741","Markus Hannikainen","CBJ","L","44","403.36666666667","4","3","2","1","7","77.78"
"758","Troy Terry","ANA","R","32","372.26666666667","2","5","4","1","7","46.67"
"778","Maxime Lajoie","OTT","D","56","837.31666666667","3","4","2","2","7","28.00"
"787","Jesse Puljujarvi","EDM","R","46","523.03333333333","4","3","1","2","7","53.85"
"790","Sam Steel","ANA","C","22","270.05","4","3","2","1","7","58.33"
"848","Max Comtois","ANA","L","10","126.15","2","5","3","2","7","87.50"
"849","Henri Jokiharju","CHI","D","38","624.35","0","7","5","2","7","29.17"
"867","Jan Rutta","CHI, T.B","D","37","524.05","2","5","2","3","7","25.00"
"889","Igor Ozhiganov","TOR","D","53","735.83333333333","3","4","2","2","7","22.58"
"893","Egor Yakovlev","N.J","D","25","382.7","2","5","3","2","7","50.00"
"32","Dion Phaneuf","L.A","D","67","893.56666666667","1","5","1","4","6","20.00"
"42","Corey Perry","ANA","R","31","390.43333333333","4","2","2","0","6","75.00"
"80","Jack Johnson","PIT","D","82","1321.25","0","6","2","4","6","13.04"
"90","Adam McQuaid","CBJ, NYR","D","50","685.63333333333","3","3","1","2","6","23.08"
"97","Niklas Hjalmarsson","ARI","D","82","1310.6333333333","0","6","2","4","6","14.63"
"113","Jamie McGinn","FLA","L","19","182.36666666667","3","3","3","0","6","85.71"
"123","Michael Grabner","ARI","R","41","468.3","2","4","3","1","6","60.00"
"129","Andrew MacDonald","PHI","D","47","659.13333333333","0","6","3","3","6","20.69"
"162","Carl Gunnarsson","STL","D","25","348.05","3","3","0","3","6","28.57"
"249","Dmitry Kulikov","WPG","D","57","817.35","0","6","3","3","6","18.18"
"275","Gabriel Bourque","COL","L","55","388.35","1","5","4","1","6","42.86"
"277","Erik Haula","VGK","C, L","15","197.36666666667","2","4","3","1","6","75.00"
"357","Kevan Miller","BOS","D","39","602.33333333333","0","6","3","3","6","26.09"
"365","Lukas Sedlak","CBJ","C","47","389.38333333333","4","2","1","1","6","50.00"
"425","Stefan Noesen","N.J","R","41","484.3","2","4","2","2","6","66.67"
"465","Slater Koekkoek","CHI, T.B","D","31","441.13333333333","2","4","2","2","6","24.00"
"593","Jean-Sebastien Dea","N.J, PIT","C","23","212.56666666667","4","2","0","2","6","85.71"
"603","Christian Folin","MTL, PHI","D","45","651.51666666667","0","6","1","5","6","18.18"
"632","Robby Fabbri","STL","C","32","367.4","2","4","2","2","6","40.00"
"651","Christian Dvorak","ARI","C","20","246.65","1","5","4","1","6","66.67"
"756","Christian Jaros","OTT","D","61","808.1","1","5","3","2","6","25.00"
"763","Matt Roy","L.A","D","25","379.06666666667","2","4","0","4","6","31.58"
"770","Casey Nelson","BUF","D","38","533.81666666667","1","5","2","3","6","30.00"
"802","Dennis Cholowski","DET","D","52","767.38333333333","3","3","3","0","6","25.00"
"868","Drake Batherson","OTT","R","20","230.1","1","5","3","2","6","60.00"
"888","Lawrence Pilut","BUF","D","33","534.91666666667","1","5","3","2","6","28.57"
"15","Dan Hamhuis","NSH","D","57","798.83333333333","0","5","1","4","5","20.00"
"20","Trevor Daley","DET","D","44","663.23333333333","1","4","2","2","5","20.00"
"26","Jonathan Ericsson","DET","D","52","757.56666666667","3","2","1","1","5","23.81"
"40","Ryan Kesler","ANA","C","60","714.33333333333","4","1","1","0","5","38.46"
"217","Mark Borowiecki","OTT","D","53","731.71666666667","1","4","2","2","5","21.74"
"266","Chris Wideman","EDM, FLA, OTT","D","25","265.26666666667","1","4","3","1","5","55.56"
"271","Kevin Connauton","ARI","D","50","747.36666666667","1","4","1","3","5","20.00"
"296","Martin Marincin","TOR","D","24","327.81666666667","1","4","1","3","5","35.71"
"336","Michael Chaput","MTL","C","32","291.3","0","5","3","2","5","62.50"
"398","Brett Ritchie","DAL","R","53","469.8","3","2","0","2","5","50.00"
"403","Miikka Salomaki","NSH","R","37","375.2","1","4","1","3","5","45.45"
"475","Mackenzie MacEachern","STL","L","29","231.41666666667","3","2","1","1","5","83.33"
"484","Martin Frk","DET","R","30","242.65","0","5","4","1","5","71.43"
"502","Paul LaDue","L.A","D","33","425.91666666667","2","3","1","2","5","31.25"
"535","John Hayden","CHI","R","54","457.91666666667","3","2","1","1","5","41.67"
"546","Ben Harpur","OTT","D","51","755.75","1","4","3","1","5","20.83"
"547","Ryan Graves","COL","D","26","255.51666666667","3","2","1","1","5","38.46"
"564","Carl Dahlstrom","CHI","D","38","622.11666666667","0","5","2","3","5","14.71"
"598","Josh Currie","EDM","R","21","181.65","2","3","2","1","5","71.43"
"715","Caleb Jones","EDM","D","17","290.46666666667","1","4","2","2","5","45.45"
"716","Noah Juulsen","MTL","D","21","308.1","1","4","0","4","5","27.78"
"732","Jacob Larsson","ANA","D","49","760.96666666667","0","5","2","3","5","20.00"
"745","Dean Kukan","CBJ","D","25","331.85","0","5","3","2","5","38.46"
"775","Joey Anderson","N.J","R","34","384.61666666667","2","3","3","0","5","50.00"
"789","Dillon Dube","CGY","C","25","231.53333333333","1","4","0","4","5","55.56"
"828","Alexandre Fortin","CHI","L","24","239.66666666667","2","3","2","1","5","71.43"
"853","Lias Andersson","NYR","C","42","417.61666666667","1","4","2","2","5","55.56"
"870","Sheldon Dries","COL","C","40","318.06666666667","2","3","2","1","5","55.56"
"887","Karson Kuhlman","BOS","C","11","124.6","3","2","1","1","5","55.56"
"901","Taro Hirose","DET","L","10","140.11666666667","1","4","3","1","5","83.33"
"125","Korbinian Holzer","ANA","D","22","289.55","1","3","0","3","4","25.00"
"159","Brandon Sutter","VAN","C","26","324.83333333333","2","2","1","1","4","50.00"
"208","Michael Stone","CGY","D","14","189.16666666667","0","4","1","3","4","50.00"
"269","Nicolas Deslauriers","MTL","L","48","459.48333333333","1","3","1","2","4","44.44"
"273","Corban Knight","PHI","C","23","199.53333333333","1","3","1","2","4","100.00"
"286","Brandon Manning","CHI, EDM","D","39","502.05","2","2","1","1","4","25.00"
"304","Connor Brickley","NYR","L","14","125.61666666667","1","3","2","1","4","80.00"
"373","Fredrik Claesson","NYR","D","37","567.7","2","2","2","0","4","23.53"
"383","Andy Welinski","ANA","D","26","384.91666666667","1","3","2","1","4","30.77"
"384","Alan Quine","CGY","C","13","119.6","2","2","0","2","4","100.00"
"433","Kurtis Gabriel","N.J","R","22","161.11666666667","2","2","2","0","4","66.67"
"449","Phillip Di Giuseppe","CAR, NSH","L","24","227.9","1","3","1","2","4","57.14"
"490","Charles Hudon","MTL","L","32","320.31666666667","3","1","0","1","4","44.44"
"510","Jaycob Megna","ANA","D","28","346.21666666667","1","3","2","1","4","33.33"
"542","Peter Cehlarik","BOS","L","20","222.16666666667","2","2","1","1","4","57.14"
"561","Steven Santini","N.J","D","39","608.83333333333","1","3","1","2","4","22.22"
"594","Ross Johnston","NYI","L","17","133.46666666667","1","3","2","1","4","57.14"
"608","Frederick Gaudreau","NSH","C","55","487.46666666667","3","1","1","0","4","30.77"
"625","Julius Honka","DAL","D","29","366.53333333333","0","4","4","0","4","26.67"
"653","Juho Lammikko","FLA","R","40","360.08333333333","0","4","3","1","4","57.14"
"674","Sammy Blais","STL","L","32","307.46666666667","2","2","2","0","4","40.00"
"689","Jonas Siegenthaler","WSH","D","26","336","0","4","2","2","4","28.57"
"744","Andreas Martinsen","CHI","L","24","182.63333333333","1","3","3","0","4","80.00"
"764","Sami Niku","WPG","D","30","404.65","1","3","0","3","4","28.57"
"783","Carl Grundstrom","L.A","R","15","190.71666666667","4","0","0","0","4","66.67"
"795","Max Jones","ANA","L","30","348.96666666667","2","2","2","0","4","40.00"
"894","Ilya Lyubushkin","ARI","D","41","548.43333333333","0","4","3","1","4","26.67"
"10","Matt Hendricks","MIN, WPG","C","26","208.86666666667","0","3","3","0","3","60.00"
"121","Patrik Berglund","BUF","C","23","251.48333333333","1","2","1","1","3","75.00"
"140","Steven Kampfer","BOS","D","35","453.53333333333","2","1","1","0","3","23.08"
"155","Thomas Hickey","NYI","D","40","619.58333333333","0","3","2","1","3","13.64"
"179","Micheal Haley","FLA, S.J","C","43","343.28333333333","1","2","2","0","3","37.50"
"223","Zac Rinaldo","NSH","C, L","23","162.66666666667","1","2","2","0","3","75.00"
"346","Kevin Gravel","EDM","D","36","466.95","0","3","2","1","3","18.75"
"347","Anthony Bitetto","MIN, NSH","D","36","415.65","0","3","1","2","3","27.27"
"354","Ben Street","ANA","C","21","208.51666666667","3","0","0","0","3","100.00"
"364","Scott Wilson","BUF","L","15","151.41666666667","0","3","2","1","3","100.00"
"402","Xavier Ouellet","MTL","D","19","289.31666666667","0","3","1","2","3","37.50"
"436","Brad Hunt","MIN, VGK","D","42","510.16666666667","1","2","2","0","3","21.43"
"450","Brendan Gaunce","VAN","C","3","22.833333333333","1","2","1","1","3","75.00"
"495","Gemel Smith","BOS, DAL","C","17","141.36666666667","2","1","1","0","3","75.00"
"532","Jonny Brodzinski","L.A","L","13","125.11666666667","2","1","1","0","3","60.00"
"557","Valentin Zykov","CAR, EDM, VGK","L","28","235.35","2","1","0","1","3","75.00"
"562","Nic Petan","TOR, WPG","C, L","18","128.78333333333","1","2","1","1","3","75.00"
"647","Vladislav Kamenev","COL","C","23","168.56666666667","0","3","1","2","3","60.00"
"668","Clark Bishop","CAR","C","20","181.38333333333","1","2","2","0","3","37.50"
"671","Anders Bjork","BOS","L","20","216.23333333333","1","2","1","1","3","75.00"
"734","Denis Gurianov","DAL","R","21","201.53333333333","1","2","1","1","3","100.00"
"800","Jordan Kyrou","STL","C","16","148.28333333333","1","2","2","0","3","75.00"
"810","Nathan Bastian","N.J","R","7","73.983333333333","3","0","0","0","3","100.00"
"811","Michael McLeod","N.J","C","21","246","0","3","1","2","3","100.00"
"814","Alexander Nylander","BUF","R","12","133.3","1","2","2","0","3","75.00"
"834","Joseph Gambardella","EDM","C","15","121.4","0","3","2","1","3","50.00"
"836","Juuso Valimaki","CGY","D","24","331.06666666667","1","2","1","1","3","30.00"
"852","Ryan Poehling","MTL","C","1","10.166666666667","3","0","0","0","3","100.00"
"863","Oscar Fantenberg","CGY, L.A","D","61","870.68333333333","2","1","1","0","3","10.34"
"869","Max Veronneau","OTT","R","12","134.16666666667","1","2","0","2","3","100.00"
"891","Juuso Riikola","PIT","D","37","559.95","0","3","1","2","3","14.29"
"69","Andrej Sekera","EDM","D","24","340.11666666667","0","2","1","1","2","13.33"
"74","Matt Hunwick","BUF","D","14","199.35","0","2","2","0","2","66.67"
"95","Chris Butler","STL","D","13","168.71666666667","1","1","1","0","2","28.57"
"96","Tom Pyatt","OTT","L","37","362.11666666667","0","2","1","1","2","50.00"
"187","Luke Schenn","ANA, VAN","D","26","327.16666666667","0","2","0","2","2","28.57"
"207","Jori Lehtera","PHI","C","27","201.03333333333","1","1","1","0","2","40.00"
"222","Luke Witkowski","DET","R","34","303.93333333333","0","2","2","0","2","16.67"
"225","Dalton Prout","CGY","D","20","236.61666666667","1","1","1","0","2","18.18"
"282","Jordan Nolan","STL","C","14","109.48333333333","0","2","1","1","2","28.57"
"285","Darren Archibald","OTT, VAN","R","12","88.3","1","1","0","1","2","66.67"
"288","Andrew Agozzino","COL","L","11","79.65","1","1","0","1","2","66.67"
"313","Alex Petrovic","EDM, FLA","D","35","514.51666666667","0","2","0","2","2","22.22"
"434","Tomas Hyka","VGK","R","17","163.26666666667","1","1","0","1","2","28.57"
"520","Chad Ruhwedel","PIT","D","18","259.7","1","1","0","1","2","33.33"
"525","Tyler Lewington","WSH","D","2","26.483333333333","1","1","0","1","2","66.67"
"533","Josh Brown","FLA","D","37","455.61666666667","1","1","0","1","2","18.18"
"544","Nick Paul","OTT","L","20","168.33333333333","1","1","0","1","2","50.00"
"553","Ian McCoshen","FLA","D","19","230.96666666667","1","1","0","1","2","28.57"
"638","Joshua Ho-Sang","NYI","R","10","124.85","1","1","1","0","2","66.67"
"676","Victor Olofsson","BUF","L","6","93.45","0","2","2","0","2","50.00"
"683","Danick Martel","T.B","L","9","89.55","0","2","2","0","2","50.00"
"703","A.J. Greer","COL","L","15","93.8","1","1","1","0","2","100.00"
"752","Mikhail Vorobyev","PHI","C","15","125.9","1","1","0","1","2","33.33"
"766","Philippe Myers","PHI","D","21","292.13333333333","1","1","0","1","2","22.22"
"798","Josh Mahura","ANA","D","17","218.1","1","1","0","1","2","33.33"
"832","Gavin Bayreuther","DAL","D","19","300.98333333333","1","1","1","0","2","18.18"
"851","Martin Necas","CAR","C","7","54.45","1","1","0","1","2","100.00"
"858","C.J. Smith","BUF","L","11","113.23333333333","2","0","0","0","2","66.67"
"872","Adam Johnson","PIT","C","6","31.833333333333","0","2","1","1","2","66.67"
"882","Isac Lundestrom","ANA","C","15","169.65","0","2","1","1","2","33.33"
"18","Tomas Plekanec","MTL","C","3","26.883333333333","1","0","0","0","1","50.00"
"76","Cody McLeod","NSH, NYR","L","38","245.16666666667","1","0","0","0","1","25.00"
"83","Martin Hanzal","DAL","C","7","64.2","0","1","1","0","1","50.00"
"116","Matt Beleskey","NYR","L","4","29.483333333333","1","0","0","0","1","100.00"
"130","Erik Condra","DAL","R","6","68.2","1","0","0","0","1","100.00"
"137","Karl Alzner","MTL","D","9","132.68333333333","0","1","1","0","1","25.00"
"144","Eric Tangradi","N.J","L","6","71.916666666667","0","1","1","0","1","100.00"
"193","Luca Sbisa","NYI","D","9","122.06666666667","0","1","0","1","1","33.33"
"202","Zac Dalpe","CBJ","C","1","9.0166666666667","0","1","1","0","1","100.00"
"210","Matt Donovan","NSH","D","2","14.533333333333","0","1","0","1","1","100.00"
"221","Mark Barberio","COL","D","12","151.11666666667","1","0","0","0","1","25.00"
"224","Matt Bartkowski","MIN","D","2","20.333333333333","1","0","0","0","1","50.00"
"229","Brian Lashoff","DET","D","4","49.683333333333","0","1","0","1","1","50.00"
"259","Stefan Elliott","OTT","D","3","23.9","0","1","0","1","1","100.00"
"274","Wade Megan","DET","C","11","84.866666666667","0","1","1","0","1","50.00"
"284","Justin Dowling","DAL","C","11","127.01666666667","0","1","1","0","1","50.00"
"297","Justin Holl","TOR","D","11","135.6","0","1","0","1","1","16.67"
"342","Sam Carrick","ANA","C","6","59.733333333333","0","1","1","0","1","100.00"
"348","Brandon Davidson","CHI","D","10","122.21666666667","0","1","0","1","1","33.33"
"356","Matt Read","MIN","R","12","129.28333333333","1","0","0","0","1","20.00"
"367","Max McCormick","OTT","L","14","100.58333333333","1","0","0","0","1","100.00"
"374","Blake Pietila","N.J","L","19","222.8","0","1","1","0","1","25.00"
"386","Kyle Rau","MIN","C","6","41.666666666667","0","1","0","1","1","100.00"
"438","Cameron Schilling","WPG","D","4","43.95","0","1","0","1","1","50.00"
"457","Jordan Schmaltz","STL","D","20","212.28333333333","0","1","1","0","1","20.00"
"491","Dominic Toninato","COL","C","2","12.933333333333","1","0","0","0","1","100.00"
"513","Kurtis MacDermid","L.A","D","11","96.683333333333","0","1","1","0","1","25.00"
"514","Ashton Sautner","VAN","D","17","239.28333333333","0","1","0","1","1","14.29"
"530","Connor Clifton","BOS","D","19","317.28333333333","0","1","0","1","1","10.00"
"559","Remi Elie","BUF","L","16","147.01666666667","0","1","0","1","1","100.00"
"563","Dillon Heatherington","DAL","D","5","50.683333333333","0","1","1","0","1","20.00"
"565","Justin Bailey","PHI","R","11","63.083333333333","0","1","1","0","1","50.00"
"597","Nathan Walker","WSH","L","3","21.933333333333","0","1","1","0","1","100.00"
"606","Daniel Carr","VGK","L","6","58.116666666667","1","0","0","0","1","50.00"
"618","Haydn Fleury","CAR","D","20","241.11666666667","0","1","1","0","1","7.69"
"627","Sonny Milano","CBJ","L","8","64.916666666667","1","0","0","0","1","33.33"
"636","Nikita Scherbak","L.A","R","8","79.816666666667","1","0","0","0","1","50.00"
"640","John Quenneville","N.J","C","19","194.78333333333","1","0","0","0","1","16.67"
"666","Michael Bunting","ARI","L","5","47.683333333333","1","0","0","0","1","100.00"
"672","Rourke Chartier","S.J","C","13","116.53333333333","1","0","0","0","1","50.00"
"678","Jacob Middleton","S.J","D","3","28.6","0","1","0","1","1","50.00"
"704","Brendan Guhle","ANA, BUF","D","8","107.5","0","1","1","0","1","50.00"
"724","Jeremy Lauzon","BOS","D","16","211.3","1","0","0","0","1","33.33"
"731","Filip Chlapik","OTT","C","5","59.266666666667","1","0","0","0","1","50.00"
"768","Tanner Fritz","NYI","C","8","83.733333333333","0","1","1","0","1","100.00"
"771","Kalle Kossila","ANA","C","8","65.383333333333","1","0","0","0","1","100.00"
"782","Libor Hajek","NYR","D","5","74.283333333333","1","0","0","0","1","33.33"
"797","Dante Fabbro","NSH","D","4","48.65","1","0","0","0","1","100.00"
"812","Ben Gleason","DAL","D","4","53.55","0","1","1","0","1","50.00"
"816","Jacob MacDonald","FLA","D","2","22.766666666667","1","0","0","0","1","100.00"
"830","Zack MacEwen","VAN","C","4","25.85","0","1","1","0","1","100.00"
"833","Vinni Lettieri","NYR","C","27","253.58333333333","0","1","0","1","1","33.33"
"837","Kailer Yamamoto","EDM","R","17","195.88333333333","1","0","0","0","1","25.00"
"839","Jaret Anderson-Dolan","L.A","C","5","48.55","0","1","1","0","1","50.00"
"843","Kristian Vesalainen","WPG","L","5","32.866666666667","0","1","0","1","1","100.00"
"844","Eeli Tolvanen","NSH","R","4","47.283333333333","1","0","0","0","1","50.00"
"847","Alex Formenton","OTT","L","9","99.233333333333","1","0","0","0","1","33.33"
"855","Alexandre Texier","CBJ","C","2","25.533333333333","1","0","0","0","1","33.33"
"864","Calle Rosen","TOR","D","4","61.633333333333","1","0","0","0","1","25.00"
"875","Joel L'Esperance","DAL","C","18","195.6","1","0","0","0","1","100.00"
"876","Daniel Brickley","L.A","D","4","49.516666666667","0","1","1","0","1","50.00"
"879","Quinn Hughes","VAN","D","5","76.566666666667","0","1","1","0","1","50.00"
"906","Jimmy Schuldt","VGK","D","1","19.116666666667","0","1","1","0","1","50.00"
"5","Derek MacKenzie","FLA","C","1","2.7166666666667","0","0","0","0","0","-"
"16","Chris Thorburn","STL","R","1","1.8666666666667","0","0","0","0","0","-"
"43","Patrick Eaves","ANA","R","7","84.533333333333","0","0","0","0","0","0.00"
"48","Lee Stempniak","BOS","R","2","15.516666666667","0","0","0","0","0","-"
"50","Marc Methot","DAL","D","9","132.25","0","0","0","0","0","0.00"
"75","Adam Cracknell","ANA","R","2","20.5","0","0","0","0","0","-"
"104","Stephen Gionta","NYI","C, R","5","38.433333333333","0","0","0","0","0","-"
"114","Eric Gryba","N.J","D","10","138.93333333333","0","0","0","0","0","0.00"
"133","David Schlemko","MTL","D","18","282.66666666667","0","0","0","0","0","0.00"
"134","Mark Letestu","CBJ","C","2","17.95","0","0","0","0","0","-"
"138","Justin Falk","OTT","D","10","117.16666666667","0","0","0","0","0","0.00"
"141","Paul Carey","BOS, OTT","C","7","72.95","0","0","0","0","0","0.00"
"153","Anthony Peluso","CGY","R","4","16.45","0","0","0","0","0","-"
"157","Brad Malone","EDM","C","16","127.05","0","0","0","0","0","0.00"
"182","Jason Garrison","EDM","D","17","178.26666666667","0","0","0","0","0","0.00"
"199","Cody Goloubef","OTT","D","5","52.083333333333","0","0","0","0","0","0.00"
"203","Cameron Gaunce","T.B","D","2","28.583333333333","0","0","0","0","0","0.00"
"290","Nate Prosser","MIN","D","15","146","0","0","0","0","0","0.00"
"302","Mark Alt","COL","D","2","19","0","0","0","0","0","-"
"331","Dylan McIlrath","DET","D","7","92.533333333333","0","0","0","0","0","0.00"
"349","Zach Trotman","PIT","D","13","171.71666666667","0","0","0","0","0","0.00"
"353","Erik Burgdoerfer","OTT","D","4","39.75","0","0","0","0","0","-"
"358","Cory Conacher","T.B","C","1","7.6166666666667","0","0","0","0","0","-"
"360","Colin Blackwell","NSH","C","6","57","0","0","0","0","0","-"
"381","Steven Fogarty","NYR","C","10","77.6","0","0","0","0","0","0.00"
"389","Reid Boucher","VAN","C","1","5.4666666666667","0","0","0","0","0","-"
"393","Adam Clendening","CBJ","D","4","35.466666666667","0","0","0","0","0","0.00"
"417","Ryan Murphy","MIN, N.J","D","3","30.616666666667","0","0","0","0","0","0.00"
"427","Matt Puempel","DET","L","8","77.383333333333","0","0","0","0","0","-"
"440","Matt Tennyson","BUF","D","4","40.716666666667","0","0","0","0","0","0.00"
"492","Trevor Carrick","CAR","D","1","11.483333333333","0","0","0","0","0","-"
"497","Kevin Roy","ANA","L","3","34.866666666667","0","0","0","0","0","-"
"501","Danny O'Regan","BUF","C","1","11.05","0","0","0","0","0","-"
"505","Jake Dotchin","ANA","D","20","221.3","0","0","0","0","0","0.00"
"506","Joseph Blandisi","ANA, PIT","C","9","64.866666666667","0","0","0","0","0","0.00"
"515","Andrej Sustr","ANA","D","5","58.6","0","0","0","0","0","0.00"
"522","Anton Blidh","BOS","L","1","12.333333333333","0","0","0","0","0","-"
"523","John Gilmour","NYR","D","5","78.966666666667","0","0","0","0","0","0.00"
"531","Luke Johnson","CHI","C","15","135.7","0","0","0","0","0","0.00"
"534","Tyrell Goulbourne","PHI","L","2","14.816666666667","0","0","0","0","0","-"
"550","Marko Dano","COL","C","8","53.733333333333","0","0","0","0","0","0.00"
"558","Laurent Dauphin","ARI","C","1","12.316666666667","0","0","0","0","0","-"
"582","Samuel Morin","PHI","D","5","57.283333333333","0","0","0","0","0","0.00"
"588","Curtis Lazar","CGY","C","1","4.8","0","0","0","0","0","-"
"590","Kerby Rychel","CGY","L","2","17.85","0","0","0","0","0","-"
"596","Dakota Mermis","ARI","D","1","11.333333333333","0","0","0","0","0","0.00"
"599","Joel Hanley","DAL","D","16","206.38333333333","0","0","0","0","0","0.00"
"605","Jake Chelios","DET","D","5","81.15","0","0","0","0","0","0.00"
"645","Andreas Englund","OTT","D","3","37.266666666667","0","0","0","0","0","-"
"646","Josh Jacobs","N.J","D","1","14.9","0","0","0","0","0","-"
"648","Nicolas Aube-Kubel","PHI","R","9","49.866666666667","0","0","0","0","0","0.00"
"652","Dominic Turgeon","DET","C","4","42.533333333333","0","0","0","0","0","-"
"656","Louie Belpedio","MIN","D","2","25.316666666667","0","0","0","0","0","0.00"
"657","Mark Friedman","PHI","D","1","12.55","0","0","0","0","0","-"
"660","Chase De Leo","ANA","C","1","10.633333333333","0","0","0","0","0","0.00"
"661","Nelson Nogier","WPG","D","1","9.3166666666667","0","0","0","0","0","-"
"670","Anton Lindholm","COL","D","2","12.683333333333","0","0","0","0","0","-"
"679","Joe Hicketts","DET","D","11","173.93333333333","0","0","0","0","0","0.00"
"682","Jack Rodewald","OTT","R","6","42.333333333333","0","0","0","0","0","-"
"685","Nikita Soshnikov","STL","R","5","35.7","0","0","0","0","0","0.00"
"696","Anthony Richard","NSH","C","1","7.3666666666667","0","0","0","0","0","-"
"699","Jakub Zboril","BOS","D","2","21.15","0","0","0","0","0","-"
"710","Cooper Marody","EDM","C","6","40.916666666667","0","0","0","0","0","-"
"720","Nicolas Roy","CAR","C","6","40.866666666667","0","0","0","0","0","-"
"722","Guillaume Brisebois","VAN","D","8","87.783333333333","0","0","0","0","0","0.00"
"728","Kyle Capobianco","ARI","D","2","26.75","0","0","0","0","0","-"
"730","Zach Senyshyn","BOS","R","2","21.616666666667","0","0","0","0","0","-"
"737","Dennis Gilbert","CHI","D","1","12.766666666667","0","0","0","0","0","-"
"738","Gabriel Carlsson","CBJ","D","1","8.3666666666667","0","0","0","0","0","-"
"748","Kevin Stenlund","CBJ","C","4","43.766666666667","0","0","0","0","0","-"
"749","William Borgen","BUF","D","4","62.883333333333","0","0","0","0","0","-"
"750","Colton White","N.J","D","3","41.583333333333","0","0","0","0","0","0.00"
"765","Kole Sherwood","CBJ","R","2","15.933333333333","0","0","0","0","0","-"
"767","Ryan Lomberg","CGY","L","4","26.05","0","0","0","0","0","-"
"769","Nick Lappin","N.J","R","11","133.55","0","0","0","0","0","0.00"
"779","Ryan Lindgren","NYR","D","5","68.6","0","0","0","0","0","0.00"
"781","Brandon Gignac","N.J","C","1","9.0666666666667","0","0","0","0","0","-"
"792","Timothy Gettinger","NYR","L","4","30.083333333333","0","0","0","0","0","0.00"
"793","Trent Frederic","BOS","C","15","134.4","0","0","0","0","0","-"
"794","Logan Brown","OTT","C","2","15.9","0","0","0","0","0","-"
"801","Riley Stillman","FLA","D","1","11.366666666667","0","0","0","0","0","0.00"
"805","Jake Bean","CAR","D","2","16.6","0","0","0","0","0","-"
"809","Vitaly Abramov","OTT","R","1","12.233333333333","0","0","0","0","0","-"
"818","Anthony Greco","FLA","R","1","9.5","0","0","0","0","0","-"
"821","Patrick Russell","EDM","R","6","48.583333333333","0","0","0","0","0","-"
"823","Janne Kuokkanen","CAR","L","7","59.433333333333","0","0","0","0","0","0.00"
"824","Rem Pitlick","NSH","C","1","9.65","0","0","0","0","0","-"
"825","Maxim Mamin","FLA","C","7","50.65","0","0","0","0","0","-"
"826","Dylan Gambrell","S.J","C","8","65.466666666667","0","0","0","0","0","0.00"
"841","Urho Vaakanainen","BOS","D","2","17.233333333333","0","0","0","0","0","-"
"854","Erik Brannstrom","OTT","D","2","29.05","0","0","0","0","0","-"
"857","Justin Kloos","ANA","C","1","7.0666666666667","0","0","0","0","0","-"
"860","Jakub Jerabek","STL","D","1","7.4166666666667","0","0","0","0","0","-"
"866","Libor Sulak","DET","D","6","98.266666666667","0","0","0","0","0","0.00"
"874","Eric Robinson","CBJ","L","13","150.91666666667","0","0","0","0","0","0.00"
"877","Sheldon Rempal","L.A","R","7","59.183333333333","0","0","0","0","0","0.00"
"881","Evan Bouchard","EDM","D","7","71.183333333333","0","0","0","0","0","0.00"
"883","Filip Zadina","DET","R","9","111.5","0","0","0","0","0","0.00"
"895","Jacob Nilsson","CHI","C","2","13.733333333333","0","0","0","0","0","-"
"898","Logan O'Connor","COL","R","5","31.466666666667","0","0","0","0","0","-"
"899","Josh Teves","VAN","D","1","13.283333333333","0","0","0","0","0","-"
"900","Ryan Kuffner","DET","L","10","100.2","0","0","0","0","0","-"
"902","Brady Keeper","FLA","D","1","11.766666666667","0","0","0","0","0","0.00"
"903","Nico Sturm","MIN","C","2","23.3","0","0","0","0","0","-"
"904","Brogan Rafferty","VAN","D","2","26.666666666667","0","0","0","0","0","-"
"905","Blake Lizotte","L.A","C","1","11.2","0","0","0","0","0","-"