"","Player","Team","Position","GP","TOI","Goals","Total Assists","First Assists","Second Assists","Total Points","IPP"
"671","Artemi Panarin","NYR","C, L","69","1078.9166666667","21","38","22","16","59","78.67"
"541","Leon Draisaitl","EDM","C","71","1163.75","22","34","21","13","56","81.16"
"502","Nathan MacKinnon","COL","C","69","1075.4166666667","18","34","25","9","52","75.36"
"123","Patrick Kane","CHI","R","70","1140.8666666667","19","31","21","10","50","84.75"
"618","Connor McDavid","EDM","C","64","1055.6833333333","21","29","17","12","50","80.65"
"343","Nikita Kucherov","T.B","R","68","957.83333333333","20","28","14","14","48","81.36"
"561","David Pastrnak","BOS","R","70","985.55","25","23","16","7","48","78.69"
"39","Evgeni Malkin","PIT","C","55","805.56666666667","16","30","16","14","46","85.19"
"78","Brad Marchand","BOS","C, L","70","906.23333333333","21","25","20","5","46","75.41"
"547","Nikolaj Ehlers","WPG","L","71","1013.9166666667","18","28","20","8","46","93.88"
"708","Auston Matthews","TOR","C","70","1151.4833333333","30","15","11","4","45","71.43"
"579","Brayden Point","T.B","C","66","943.46666666667","17","27","18","9","44","66.67"
"350","Mark Scheifele","WPG","C","71","1202.2333333333","13","29","17","12","42","62.69"
"356","J.T. Miller","VAN","C","69","991.93333333333","18","24","14","10","42","71.19"
"97","Jonathan Toews","CHI","C","70","939.01666666667","11","30","16","14","41","74.55"
"346","Jonathan Huberdeau","FLA","C, L","69","973.21666666667","15","26","18","8","41","66.13"
"362","Phillip Danault","MTL","C, L","71","990.81666666667","11","30","14","16","41","69.49"
"128","Max Pacioretty","VGK","L","71","1028.4166666667","20","20","14","6","40","71.43"
"614","Kyle Connor","WPG","L","71","1104.9166666667","21","19","12","7","40","76.92"
"792","Elias Pettersson","VAN","C","68","921.78333333333","18","22","15","7","40","64.52"
"208","Tomas Tatar","MTL","L","68","901.76666666667","10","29","14","15","39","73.58"
"351","Sean Couturier","PHI","C","69","964.6","15","24","10","14","39","70.91"
"639","Mathew Barzal","NYI","C","68","1103.55","13","26","20","6","39","79.59"
"141","Steven Stamkos","T.B","C","57","769.01666666667","14","24","17","7","38","77.55"
"157","Roman Josi","NSH","D","69","1308.3166666667","10","28","17","11","38","51.35"
"294","Mark Stone","VGK","R","65","908.15","13","25","17","8","38","76.00"
"546","William Nylander","TOR","C, R","68","981.28333333333","19","19","11","8","38","79.17"
"551","Jakub Vrana","WSH","L","69","850.86666666667","22","16","12","4","38","77.55"
"38","Alex Ovechkin","WSH","L","68","980.01666666667","27","10","7","3","37","77.08"
"207","Reilly Smith","VGK","R","71","933.76666666667","17","20","12","8","37","77.08"
"349","Mika Zibanejad","NYR","C","57","796.35","19","18","11","7","37","80.43"
"629","Sebastian Aho","CAR","C, R","68","918.76666666667","21","16","10","6","37","69.81"
"129","Jakub Voracek","PHI","R","69","913.73333333333","7","29","19","10","36","76.60"
"155","John Carlson","WSH","D","69","1191.9333333333","11","25","15","10","36","56.25"
"188","Ryan O'Reilly","STL","C","71","1016.7166666667","7","29","17","12","36","69.23"
"286","Brendan Gallagher","MTL","R","59","824.65","19","17","11","6","36","67.92"
"503","Aleksander Barkov","FLA","C","66","933.58333333333","13","23","13","10","36","75.00"
"624","Timo Meier","S.J","R","70","960.15","17","19","13","6","36","90.00"
"438","Connor Brown","OTT","R","71","1056.9833333333","13","22","9","13","35","83.33"
"456","Dominik Kubalik","CHI","L","68","812.25","23","12","9","3","35","71.43"
"540","Sam Reinhart","BUF","C","69","1100.7666666667","16","19","13","6","35","72.92"
"619","Jack Eichel","BUF","C","68","1124.65","17","18","8","10","35","63.64"
"718","Patrik Laine","WPG","R","68","1035.3833333333","15","20","10","10","35","66.04"
"344","Ryan Nugent-Hopkins","EDM","C","65","914.01666666667","15","19","12","7","34","75.56"
"549","Kevin Fiala","MIN","L","64","774.8","13","21","14","7","34","82.93"
"552","Dylan Larkin","DET","C","71","1137.0166666667","12","22","12","10","34","68.00"
"796","Robert Thomas","STL","C","66","830.68333333333","9","25","18","7","34","77.27"
"844","Andrei Svechnikov","CAR","R","68","876.93333333333","13","21","7","14","34","62.96"
"105","Nick Bonino","NSH","C","67","796.83333333333","16","17","10","7","33","70.21"
"248","Evgeny Kuznetsov","WSH","C","63","839.8","13","20","12","8","33","73.33"
"255","Brock Nelson","NYI","C","68","951.01666666667","15","18","9","9","33","75.00"
"279","Bryan Rust","PIT","R","55","779.75","16","17","9","8","33","61.11"
"348","Ryan Strome","NYR","C","70","947.38333333333","10","23","16","7","33","57.89"
"392","Teuvo Teravainen","CAR","L","68","891.56666666667","8","25","18","7","33","66.00"
"635","Travis Konecny","PHI","C, R","66","851.78333333333","18","15","8","7","33","80.49"
"746","Pierre-Luc Dubois","CBJ","C, L","70","987.01666666667","15","18","10","8","33","78.57"
"201","Zack Kassian","EDM","R","59","870.53333333333","15","17","9","8","32","64.00"
"262","Jaden Schwartz","STL","C, L","71","1008.7166666667","9","23","13","10","32","82.05"
"470","Pavel Buchnevich","NYR","L, R","68","943.71666666667","11","21","14","7","32","59.26"
"499","Tyler Bertuzzi","DET","L","71","1065.5666666667","16","16","11","5","32","71.11"
"656","Mitchell Marner","TOR","C, R","59","883.51666666667","7","25","17","8","32","76.19"
"705","Matthew Tkachuk","CGY","L","69","974.43333333333","12","20","11","9","32","68.09"
"838","Brady Tkachuk","OTT","L","71","1059.2333333333","17","15","12","3","32","69.57"
"41","Blake Wheeler","WPG","R","71","1003.8666666667","14","17","10","7","31","75.61"
"165","Adam Henrique","ANA","C","71","917.9","18","13","9","4","31","68.89"
"196","Brayden Schenn","STL","C","71","1022.5166666667","14","17","11","6","31","73.81"
"204","Chris Kreider","NYR","C, L","63","819.36666666667","14","17","10","7","31","60.78"
"228","Anders Lee","NYI","C, L","68","1011","15","16","8","8","31","64.58"
"329","Rocco Grimaldi","NSH","C, R","66","806.13333333333","10","21","12","9","31","72.09"
"341","William Karlsson","VGK","C","63","877.28333333333","11","20","13","7","31","72.09"
"539","Aaron Ekblad","FLA","D","67","1210.8833333333","4","27","17","10","31","44.93"
"557","Nick Schmaltz","ARI","C","70","869.3","9","22","14","8","31","75.61"
"57","Anze Kopitar","L.A","C","70","1051.2833333333","12","18","10","8","30","66.67"
"110","James van Riemsdyk","PHI","L","66","791.58333333333","15","15","11","4","30","75.00"
"243","Tyler Toffoli","L.A, VAN","C, R","68","879.38333333333","16","14","8","6","30","76.92"
"268","Taylor Hall","ARI, N.J","L","65","924.75","9","21","17","4","30","75.00"
"310","Johnny Gaudreau","CGY","L","70","1020.6833333333","11","19","13","6","30","75.00"
"396","Filip Forsberg","NSH","L","63","820.71666666667","12","18","12","6","30","76.92"
"481","Andre Burakovsky","COL","L","58","705.86666666667","16","14","9","5","30","73.17"
"556","Tony DeAngelo","NYR","D","68","1032.0833333333","9","21","10","11","30","53.57"
"19","Eric Staal","MIN","C","66","869.93333333333","13","16","12","4","29","61.70"
"100","Alex Killorn","T.B","C, L","68","821.98333333333","16","13","7","6","29","67.44"
"126","Mikael Backlund","CGY","C","70","984.45","8","21","13","8","29","59.18"
"192","John Tavares","TOR","C","63","968.91666666667","13","16","11","5","29","64.44"
"441","Nikita Gusev","N.J","L","66","760.68333333333","8","21","16","5","29","78.38"
"471","Jake Guentzel","PIT","C, L","39","626.18333333333","13","16","13","3","29","78.38"
"506","Elias Lindholm","CGY","C","70","950.73333333333","17","12","8","4","29","69.05"
"609","Andrew Mangiapane","CGY","L","68","861.3","15","14","11","3","29","64.44"
"669","Anthony Cirelli","T.B","C","68","908.36666666667","11","18","13","5","29","60.42"
"153","Jordan Eberle","NYI","C, R","58","842.65","12","16","7","9","28","75.68"
"184","Mike Hoffman","FLA","C, L","69","843.86666666667","14","14","7","7","28","80.00"
"194","Matt Duchene","NSH","C","66","869.75","8","20","11","9","28","68.29"
"238","Mats Zuccarello","MIN","C, R","65","834.18333333333","11","17","9","8","28","71.79"
"303","Ondrej Palat","T.B","L","69","911.6","11","17","11","6","28","54.90"
"366","Jonathan Marchessault","VGK","C","66","930.55","13","15","13","2","28","71.79"
"424","Jaccob Slavin","CAR","D","68","1233.8","5","23","10","13","28","43.08"
"500","Zach Sanford","STL","L","58","719.1","14","14","7","7","28","68.29"
"636","Dylan Strome","CHI","C","58","730.6","8","20","13","7","28","77.78"
"806","Cale Makar","COL","D","57","921.16666666667","8","20","10","10","28","49.12"
"811","Alex Iafallo","L.A","L","70","983.73333333333","8","20","12","8","28","68.29"
"54","Sidney Crosby","PIT","C","41","610.21666666667","9","18","13","5","27","90.00"
"59","T.J. Oshie","WSH","R","69","913.3","13","14","10","4","27","56.25"
"120","David Perron","STL","L","71","1017.0166666667","11","16","11","5","27","60.00"
"133","Lars Eller","WSH","C","69","833.41666666667","10","17","12","5","27","72.97"
"154","Tyler Ennis","EDM, OTT","C, R","70","853.43333333333","11","16","12","4","27","75.00"
"249","Charlie Coyle","BOS","C","70","916.93333333333","12","15","13","2","27","69.23"
"269","Brett Connolly","FLA","R","69","880.98333333333","15","12","5","7","27","67.50"
"334","Brandon Saad","CHI","L","58","752.2","16","11","7","4","27","77.14"
"473","Anthony Duclair","OTT","L","66","795.08333333333","14","13","10","3","27","77.14"
"475","Oliver Bjorkstrand","CBJ","R","49","720.35","18","9","6","3","27","72.97"
"510","Bo Horvat","VAN","C","69","979.45","6","21","13","8","27","75.00"
"513","Max Domi","MTL","C","71","961.65","12","15","11","4","27","58.70"
"559","Kasperi Kapanen","TOR","R","69","851.3","10","17","7","10","27","79.41"
"578","Warren Foegele","CAR","L","68","836.96666666667","10","17","10","7","27","67.50"
"638","Brock Boeser","VAN","R","57","762.08333333333","10","17","9","8","27","57.45"
"684","Conor Garland","ARI","R","68","797.65","16","11","5","6","27","72.97"
"719","Clayton Keller","ARI","C, R","70","892.35","14","13","11","2","27","84.38"
"857","Dominik Kahun","BUF, PIT","C","56","666.2","10","17","10","7","27","75.00"
"20","Ryan Suter","MIN","D","69","1232.2333333333","5","21","10","11","26","41.27"
"26","Ryan Getzlaf","ANA","C","69","980.21666666667","9","17","11","6","26","66.67"
"88","Claude Giroux","PHI","C, R","69","954","11","15","6","9","26","57.78"
"108","Kevin Shattenkirk","T.B","D","70","1154.7333333333","7","19","10","9","26","45.61"
"191","Jakob Silfverberg","ANA","R","66","823.15","13","13","9","4","26","66.67"
"193","Victor Hedman","T.B","D","66","1126.9166666667","7","19","13","6","26","40.63"
"242","Jason Zucker","MIN, PIT","L","60","792.6","10","16","11","5","26","68.42"
"280","Joonas Donskoi","COL","R","65","831.68333333333","10","16","9","7","26","61.90"
"287","Jesper Fast","NYR","R","69","945.51666666667","10","16","8","8","26","57.78"
"316","Vincent Trocheck","CAR, FLA","C","62","831.66666666667","7","19","14","5","26","59.09"
"364","Rickard Rakell","ANA","L, R","65","910.61666666667","11","15","8","7","26","61.90"
"390","Tom Wilson","WSH","R","68","899.61666666667","9","17","7","10","26","57.78"
"497","Artturi Lehkonen","MTL","L","70","874.93333333333","12","14","11","3","26","72.22"
"508","Darnell Nurse","EDM","D","71","1371.2166666667","4","22","8","14","26","40.63"
"520","Anthony Mantha","DET","R","43","637.63333333333","8","18","13","5","26","76.47"
"544","Jake Virtanen","VAN","R","69","809.18333333333","11","15","9","6","26","83.87"
"577","Christian Dvorak","ARI","C, L","70","906.25","10","16","12","4","26","55.32"
"610","Frank Vatrano","FLA","C","69","816.28333333333","9","17","8","9","26","89.66"
"648","Anthony Beauvillier","NYI","L","68","954.95","11","15","11","4","26","66.67"
"660","Joel Eriksson Ek","MIN","C","62","794.76666666667","7","19","11","8","26","63.41"
"673","Noel Acciari","FLA","C","66","841.01666666667","19","7","3","4","26","61.90"
"712","Charlie McAvoy","BOS","D","67","1245.3","2","24","13","11","26","41.94"
"717","Alex DeBrincat","CHI","L, R","70","920.51666666667","7","19","14","5","26","74.29"
"23","Dustin Brown","L.A","L, R","66","951.73333333333","13","12","10","2","25","65.79"
"31","Patrice Bergeron","BOS","C","61","735.43333333333","13","12","4","8","25","54.35"
"125","Evgenii Dadonov","FLA","R","69","894.96666666667","11","14","10","4","25","51.02"
"142","Alex Pietrangelo","STL","D","70","1263.7833333333","8","17","7","10","25","37.88"
"149","Erik Karlsson","S.J","D","56","989.28333333333","4","21","11","10","25","59.52"
"187","Kyle Palmieri","N.J","C, R","65","835.4","13","12","6","6","25","67.57"
"198","Nazem Kadri","COL","C","51","643.73333333333","15","10","6","4","25","62.50"
"209","Tyson Barrie","TOR","D","70","1269.1166666667","4","21","11","10","25","42.37"
"215","Marcus Foligno","MIN","L","59","720.66666666667","11","14","8","6","25","75.76"
"271","Tyler Seguin","DAL","C","69","995.28333333333","9","16","9","7","25","83.33"
"384","Scott Laughton","PHI","C, L","49","593.65","12","13","6","7","25","75.76"
"410","Chris Tierney","OTT","C","71","938.4","5","20","12","8","25","65.79"
"440","Alexander Kerfoot","TOR","C","65","831.7","8","17","11","6","25","58.14"
"507","Sean Monahan","CGY","C","70","977.71666666667","11","14","7","7","25","67.57"
"623","Jordan Greenway","MIN","L","67","834.5","8","17","13","4","25","67.57"
"651","Thomas Chabot","OTT","D","71","1491","6","19","12","7","25","40.32"
"748","Jesper Bratt","N.J","L","60","677.41666666667","14","11","9","2","25","69.44"
"147","Josh Bailey","NYI","C, R","68","868.96666666667","8","16","12","4","24","75.00"
"218","Craig Smith","NSH","C, R","69","751.58333333333","14","10","5","5","24","52.17"
"258","Kevin Hayes","PHI","C, R","69","905.96666666667","12","12","6","6","24","70.59"
"266","Zach Hyman","TOR","C, L","51","787.05","12","12","6","6","24","54.55"
"321","Blake Coleman","N.J, T.B","C","66","857.23333333333","16","8","3","5","24","63.16"
"383","Tanner Pearson","VAN","L","69","906.28333333333","11","13","7","6","24","80.00"
"511","Valeri Nichushkin","COL","R","65","754.38333333333","11","13","5","8","24","58.54"
"560","Jared McCann","PIT","C","66","814.8","11","13","5","8","24","60.00"
"707","Luke Kunin","MIN","C","63","780.53333333333","12","12","6","6","24","72.73"
"789","Nico Hischier","N.J","C","58","770","11","13","6","7","24","75.00"
"802","Martin Necas","CAR","C","64","757.55","11","13","7","6","24","85.71"
"837","Quinn Hughes","VAN","D","68","1132.9","4","20","9","11","24","41.38"
"25","Zach Parise","MIN","L","69","872.05","9","14","6","8","23","60.53"
"27","Brent Burns","S.J","D","70","1325","7","16","9","7","23","40.35"
"65","Kris Letang","PIT","D","61","1149.9333333333","6","17","7","10","23","38.98"
"74","Patric Hornqvist","PIT","R","52","637.31666666667","13","10","4","6","23","79.31"
"106","Ian Cole","COL","D","65","949.91666666667","4","19","7","12","23","47.92"
"168","Gustav Nyquist","CBJ","C","70","964.31666666667","4","19","13","6","23","62.16"
"182","Tyler Johnson","T.B","C","65","766.2","12","11","6","5","23","62.16"
"185","Tyler Bozak","STL","C","67","780.58333333333","10","13","6","7","23","76.67"
"199","Ryan Ellis","NSH","D","49","864.65","3","20","11","9","23","38.98"
"214","Mattias Ekholm","NSH","D","68","1231.25","7","16","10","6","23","41.07"
"645","Jack Roslovic","WPG","C","71","935.55","10","13","11","2","23","62.16"
"662","Jake DeBrusk","BOS","L","65","835.38333333333","12","11","6","5","23","76.67"
"674","Derek Ryan","CGY","C","68","789.91666666667","8","15","9","6","23","76.67"
"753","Alex Nylander","CHI","L","65","705.03333333333","10","13","8","5","23","74.19"
"2","Joe Thornton","S.J","C","70","890.66666666667","4","18","8","10","22","68.75"
"46","Carl Soderberg","ARI","C","70","862.45","9","13","6","7","22","70.97"
"53","Paul Stastny","VGK","C","71","919.28333333333","10","12","6","6","22","59.46"
"79","Nick Foligno","CBJ","L","67","959.48333333333","8","14","7","7","22","61.11"
"94","Nicklas Backstrom","WSH","C","61","827.03333333333","5","17","12","5","22","51.16"
"213","Richard Panik","WSH","R","59","605.38333333333","9","13","5","8","22","64.71"
"270","Ryan Johansen","NSH","C","68","841.75","10","12","4","8","22","61.11"
"327","Jean-Gabriel Pageau","NYI, OTT","C","67","950.03333333333","15","7","3","4","22","61.11"
"345","Gabriel Landeskog","COL","L","54","810.83333333333","10","12","8","4","22","59.46"
"353","Jonas Brodin","MIN","D","69","1246.8833333333","2","20","9","11","22","37.93"
"598","Kevin Labanc","S.J","R","70","903.3","11","11","7","4","22","68.75"
"710","Adam Fox","NYR","D","70","1113.3333333333","6","16","10","6","22","34.92"
"778","Kailer Yamamoto","EDM","R","27","418.1","7","15","11","4","22","73.33"
"794","Nick Suzuki","MTL","C","71","916.03333333333","7","15","9","6","22","75.86"
"32","Shea Weber","MTL","D","65","1147.3166666667","8","13","8","5","21","36.84"
"50","Alexander Edler","VAN","D","59","1007.9833333333","3","18","8","10","21","42.00"
"67","Keith Yandle","FLA","D","69","1034.2","2","19","11","8","21","43.75"
"87","Jeff Petry","MTL","D","71","1272.3166666667","4","17","7","10","21","41.18"
"89","Jordan Staal","CAR","C","68","889.21666666667","6","15","9","6","21","60.00"
"186","Marcus Johansson","BUF","L","60","809.3","6","15","11","4","21","70.00"
"195","Evander Kane","S.J","L","64","927.06666666667","9","12","6","6","21","58.33"
"197","Oliver Ekman-Larsson","ARI","D","66","1143.7166666667","5","16","6","10","21","50.00"
"239","Calle Jarnkrok","NSH","C","64","772.63333333333","9","12","8","4","21","67.74"
"381","Brady Skjei","CAR, NYR","D","67","1160.7833333333","7","14","2","12","21","41.18"
"391","Tomas Hertl","S.J","C","48","640.35","10","11","8","3","21","70.00"
"477","Miles Wood","N.J","L","68","818.98333333333","9","12","9","3","21","75.00"
"480","Ryan Graves","COL","D","69","1058.9666666667","8","13","6","7","21","33.33"
"482","Shea Theodore","VGK","D","71","1262.1333333333","9","12","2","10","21","39.62"
"488","J.T. Compher","COL","L","67","774.03333333333","9","12","7","5","21","60.00"
"516","Ryan Pulock","NYI","D","68","1228","5","16","7","9","21","34.43"
"558","Robby Fabbri","DET, STL","C","61","778.2","9","12","7","5","21","77.78"
"567","Ivan Barbashev","STL","C","69","792.6","7","14","11","3","21","77.78"
"576","Ryan Donato","MIN","C","62","598.66666666667","14","7","2","5","21","70.00"
"626","Mikko Rantanen","COL","R","42","606.65","9","12","8","4","21","67.74"
"687","Dominik Simon","PIT","C","64","859.26666666667","7","14","7","7","21","63.64"
"801","Miro Heiskanen","DAL","D","68","1212.8833333333","3","18","12","6","21","47.73"
"873","Ilya Mikheyev","TOR","R","39","515.78333333333","6","15","8","7","21","77.78"
"3","Patrick Marleau","PIT, S.J","C, L","66","874.21666666667","9","11","6","5","20","51.28"
"47","Alex Goligoski","ARI","D","70","1249.4666666667","2","18","4","14","20","37.04"
"102","Jamie Benn","DAL","L","69","877.61666666667","8","12","7","5","20","64.52"
"109","Pat Maroon","T.B","L","64","678.65","8","12","6","6","20","68.97"
"113","Logan Couture","S.J","C","52","672.01666666667","10","10","8","2","20","76.92"
"116","Kyle Turris","NSH","C","62","733.13333333333","7","13","10","3","20","64.52"
"130","Jake Muzzin","TOR","D","53","966.36666666667","6","14","6","8","20","37.74"
"275","Mikael Granlund","NSH","C","63","868.93333333333","9","11","4","7","20","57.14"
"319","Nick Cousins","MTL, VGK","C","65","765.1","7","13","9","4","20","64.52"
"352","Dougie Hamilton","CAR","D","47","781.46666666667","9","11","7","4","20","51.28"
"372","Yanni Gourde","T.B","C","70","803.33333333333","6","14","6","8","20","66.67"
"401","Oskar Sundqvist","STL","C","57","692.18333333333","11","9","5","4","20","74.07"
"403","Chandler Stephenson","VGK, WSH","C","65","783.1","7","13","8","5","20","47.62"
"413","Damon Severson","N.J","D","69","1191.8666666667","4","16","10","6","20","46.51"
"435","Vinnie Hinostroza","ARI","C, R","68","807.78333333333","5","15","3","12","20","66.67"
"528","Conor Sheary","BUF, PIT","L","63","734.28333333333","9","11","8","3","20","64.52"
"554","Travis Sanheim","PHI","D","69","1136.3","7","13","7","6","20","35.09"
"589","Viktor Arvidsson","NSH","L, R","57","705.76666666667","11","9","5","4","20","68.97"
"591","Danton Heinen","ANA, BOS","C, L","67","796.03333333333","7","13","5","8","20","66.67"
"603","Ondrej Kase","ANA, BOS","R","55","723.06666666667","5","15","9","6","20","64.52"
"646","Zach Werenski","CBJ","D","63","1142.85","10","10","3","7","20","40.82"
"22","Jeff Carter","L.A","C","60","767.76666666667","13","6","4","2","19","82.61"
"43","Travis Zajac","N.J","C","69","902.15","6","13","4","9","19","55.88"
"48","David Krejci","BOS","C","61","850.93333333333","5","14","5","9","19","54.29"
"90","Derick Brassard","NYI","C","66","757.18333333333","6","13","6","7","19","61.29"
"132","Carl Hagelin","WSH","L","58","643.5","6","13","8","5","19","63.33"
"170","Matt Calvert","COL","L","50","572.61666666667","8","11","6","5","19","73.08"
"253","Tyler Pitlick","PHI","C","63","670.21666666667","8","11","9","2","19","61.29"
"259","Cam Fowler","ANA","D","59","1022.9166666667","7","12","3","9","19","42.22"
"265","Jeff Skinner","BUF","C, L","59","795.35","14","5","3","2","19","67.86"
"302","Ryan Dzingel","CAR","C","64","747.26666666667","3","16","12","4","19","70.37"
"314","Sean Kuraly","BOS","C","69","763","6","13","5","8","19","70.37"
"367","Barclay Goodrow","S.J, T.B","C, R","70","866.86666666667","8","11","6","5","19","63.33"
"399","Colton Parayko","STL","D","64","1228.4","6","13","3","10","19","39.58"
"451","Nate Schmidt","VGK","D","59","1045.1666666667","4","15","5","10","19","41.30"
"485","Ryan Hartman","MIN","R","69","741.76666666667","8","11","7","4","19","52.78"
"498","William Carrier","VGK","L","71","685.7","7","12","11","1","19","63.33"
"601","Victor Olofsson","BUF","L, R","54","768.3","6","13","7","6","19","54.29"
"642","Ethan Bear","EDM","D","71","1308.6833333333","4","15","6","9","19","29.69"
"691","Adam Gaudette","VAN","C","59","618.9","7","12","6","6","19","70.37"
"810","Filip Chytil","NYR","C","60","776.71666666667","13","6","5","1","19","61.29"
"845","Rasmus Dahlin","BUF","D","59","888.9","2","17","7","10","19","52.78"
"868","Kirby Dach","CHI","C","64","783.66666666667","8","11","3","8","19","57.58"
"8","Jason Spezza","TOR","C","58","544.75","7","11","9","2","18","69.23"
"42","Alexander Radulov","DAL","R","60","800.1","7","11","6","5","18","64.29"
"210","Dmitry Orlov","WSH","D","69","1275.05","2","16","10","6","18","31.03"
"226","Ben Chiarot","MTL","D","69","1317.8833333333","7","11","6","5","18","33.33"
"337","Joel Edmundson","CAR","D","68","1033.5333333333","6","12","4","8","18","40.91"
"357","Joel Armia","MTL","R","58","755.16666666667","10","8","5","3","18","56.25"
"387","Mike Matheson","FLA","D","59","935.08333333333","7","11","4","7","18","39.13"
"409","Jimmy Vesey","BUF","L","64","780.63333333333","8","10","4","6","18","54.55"
"478","Nick Paul","OTT","L","56","731.78333333333","9","9","5","4","18","72.00"
"479","Andrew Copp","WPG","C","63","863.53333333333","9","9","6","3","18","66.67"
"484","Jason Dickinson","DAL","C","65","779.95","9","9","4","5","18","58.06"
"553","Sonny Milano","ANA, CBJ","L","55","628.53333333333","6","12","7","5","18","81.82"
"597","Anders Bjork","BOS","L","58","679.95","8","10","5","5","18","66.67"
"616","Colin White","OTT","C","61","784.6","5","13","4","9","18","62.07"
"666","John Marino","PIT","D","56","929.23333333333","4","14","9","5","18","40.91"
"734","Tyson Jost","COL","C","67","710.35","7","11","7","4","18","56.25"
"745","Samuel Girard","COL","D","70","1250.9666666667","3","15","8","7","18","33.33"
"836","Joel Farabee","PHI","L","52","623.68333333333","6","12","7","5","18","62.07"
"61","Matt Niskanen","PHI","D","68","1105.8","2","15","5","10","17","31.48"
"81","Kyle Okposo","BUF","R","52","610.71666666667","8","9","8","1","17","85.00"
"92","Phil Kessel","ARI","C, R","70","907.13333333333","5","12","9","3","17","65.38"
"107","Justin Braun","PHI","D","62","920.66666666667","2","15","7","8","17","44.74"
"175","Jared Spurgeon","MIN","D","62","1018.8","8","9","5","4","17","32.08"
"189","Kyle Clifford","L.A, TOR","L","69","745.21666666667","7","10","7","3","17","65.38"
"241","Justin Holl","TOR","D","68","1082.6","1","16","6","10","17","36.17"
"283","Marcus Sorensen","S.J","L","66","788.4","6","11","8","3","17","65.38"
"338","Matt Nieto","COL","L","70","748.6","6","11","7","4","17","54.84"
"374","Alex Galchenyuk","MIN, PIT","C","59","609.31666666667","6","11","8","3","17","68.00"
"375","Morgan Rielly","TOR","D","47","877.13333333333","2","15","7","8","17","38.64"
"430","Erik Gustafsson","CGY, CHI","D","66","1092.7166666667","4","13","6","7","17","31.48"
"462","Will Butcher","N.J","D","56","865.8","3","14","7","7","17","42.50"
"584","Lucas Wallmark","CAR, FLA","C","67","696.7","9","8","5","3","17","68.00"
"587","Devon Toews","NYI","D","68","1163.1","3","14","4","10","17","38.64"
"617","Pavel Zacha","N.J","C","65","762.85","3","14","8","6","17","53.13"
"653","Lawson Crouse","ARI","L","66","785.71666666667","10","7","6","1","17","68.00"
"693","Vladislav Gavrikov","CBJ","D","69","1154.1","5","12","4","8","17","37.78"
"704","Brandon Tanev","PIT","L","68","820.85","6","11","2","9","17","77.27"
"749","Mikhail Sergachev","T.B","D","70","1130.55","4","13","4","9","17","32.69"
"760","Michal Kempny","WSH","D","58","940.83333333333","3","14","7","7","17","30.91"
"7","Ilya Kovalchuk","L.A, MTL, WSH","L","46","623.56666666667","6","10","6","4","16","64.00"
"73","Anton Stralman","FLA","D","69","1221.3","4","12","5","7","16","28.57"
"140","Drew Doughty","L.A","D","67","1283.7833333333","1","15","4","11","16","38.10"
"162","Derek Stepan","ARI","C","70","928.16666666667","7","9","6","3","16","57.14"
"227","Erik Haula","CAR, FLA","L","48","574.7","8","8","3","5","16","59.26"
"244","Johan Larsson","BUF","C, L","62","774.33333333333","5","11","7","4","16","53.33"
"273","Mark Pysyk","FLA","D","58","681.25","8","8","5","3","16","57.14"
"276","Nino Niederreiter","CAR","R","67","837.96666666667","7","9","4","5","16","53.33"
"332","Boone Jenner","CBJ","C","70","971.28333333333","7","9","5","4","16","57.14"
"363","Vladislav Namestnikov","COL, NYR, OTT","C, L","65","735.2","8","8","4","4","16","57.14"
"369","Torey Krug","BOS","D","61","936.01666666667","4","12","6","6","16","37.21"
"394","Jacob Trouba","NYR","D","70","1227.8166666667","3","13","7","6","16","39.02"
"439","Ben Hutton","L.A","D","65","1060.3","4","12","5","7","16","37.21"
"454","Michael Raffl","PHI","L","58","620.98333333333","6","10","7","3","16","66.67"
"460","MacKenzie Weegar","FLA","D","45","778.41666666667","6","10","4","6","16","39.02"
"501","Brett Pesce","CAR","D","61","1063.9333333333","4","12","7","5","16","30.19"
"515","Alexander Wennberg","CBJ","C","57","711.33333333333","4","12","5","7","16","69.57"
"548","Nick Ritchie","ANA, BOS","L","48","583","7","9","6","3","16","66.67"
"637","Brandon Carlo","BOS","D","67","1097.3333333333","2","14","5","9","16","39.02"
"661","Denis Gurianov","DAL","R","64","669.08333333333","12","4","2","2","16","57.14"
"720","Jakob Chychrun","ARI","D","63","1117.9","7","9","4","5","16","33.33"
"756","Troy Stecher","VAN","D","69","994.83333333333","5","11","3","8","16","36.36"
"72","Ryan Reaves","VGK","R","71","692.3","8","7","4","3","15","60.00"
"80","Erik Johnson","COL","D","59","984.16666666667","2","13","6","7","15","34.88"
"119","Colton Sceviour","FLA","C","69","716.23333333333","6","9","6","3","15","55.56"
"167","TJ Brodie","CGY","D","64","1094.5833333333","3","12","3","9","15","30.61"
"169","Derek Grant","ANA, PHI","C","56","572.93333333333","7","8","6","2","15","83.33"
"172","Mark Borowiecki","OTT","D","53","799.9","5","10","0","10","15","51.72"
"174","Cam Atkinson","CBJ","R","44","571.26666666667","6","9","5","4","15","78.95"
"326","Josh Leivo","VAN","L","36","451.93333333333","7","8","4","4","15","71.43"
"359","Oscar Klefbom","EDM","D","62","1110.2666666667","3","12","3","9","15","34.09"
"388","Zemgus Girgensons","BUF","C","69","780.18333333333","9","6","3","3","15","65.22"
"397","Radek Faksa","DAL","C","66","819.4","8","7","4","3","15","55.56"
"416","Teddy Blueger","PIT","C","69","884.55","9","6","4","2","15","62.50"
"418","Brock McGinn","CAR","L","68","716.71666666667","5","10","7","3","15","60.00"
"425","Andreas Athanasiou","DET, EDM","C, L","55","715.25","7","8","5","3","15","83.33"
"463","Tucker Poolman","WPG","D","57","912.48333333333","3","12","4","8","15","31.91"
"496","Madison Bowey","DET","D","53","812.41666666667","3","12","6","6","15","44.12"
"509","Rasmus Ristolainen","BUF","D","69","1181.6333333333","4","11","7","4","15","31.25"
"537","Pierre-Edouard Bellemare","COL","C, L","69","751.75","7","8","5","3","15","57.69"
"568","Marcus Pettersson","PIT","D","69","1138.2","2","13","7","6","15","28.30"
"641","Roope Hintz","DAL","L","60","698.23333333333","12","3","3","0","15","55.56"
"813","Neal Pionk","WPG","D","71","1303.35","3","12","7","5","15","32.61"
"826","Sean Walker","L.A","D","70","1124.05","3","12","8","4","15","39.47"
"11","Valtteri Filppula","DET","C","70","871.58333333333","4","10","6","4","14","58.33"
"16","Alexander Steen","STL","L","55","604.15","6","8","4","4","14","50.00"
"28","Brian Boyle","FLA","C","39","415.18333333333","5","9","4","5","14","77.78"
"37","Mark Giordano","CGY","D","60","1023.5666666667","2","12","5","7","14","34.15"
"45","Blake Comeau","DAL","L","55","665.25","7","7","3","4","14","93.33"
"60","Andrew Cogliano","DAL","C","68","720.98333333333","3","11","9","2","14","73.68"
"70","Darren Helm","DET","C, L","68","802.48333333333","8","6","2","4","14","77.78"
"203","Nick Leddy","NYI","D","60","1081.4833333333","2","12","6","6","14","35.00"
"237","Christopher Tanev","VAN","D","69","1043.0833333333","1","13","7","6","14","31.11"
"377","Matt Dumba","MIN","D","69","1222.4","4","10","5","5","14","25.00"
"429","Cedric Paquette","T.B","C","61","661.7","4","10","5","5","14","70.00"
"452","Carter Rowney","ANA","C, R","71","716.56666666667","5","9","8","1","14","56.00"
"458","Andreas Johnsson","TOR","L","43","560.16666666667","3","11","6","5","14","56.00"
"505","Seth Jones","CBJ","D","56","1062.5833333333","4","10","6","4","14","32.56"
"514","Josh Morrissey","WPG","D","65","1229.2333333333","4","10","5","5","14","28.00"
"535","Garnet Hathaway","WSH","R","66","612.26666666667","8","6","4","2","14","66.67"
"563","Adrian Kempe","L.A","C, L","69","818.4","4","10","7","3","14","73.68"
"575","Brandon Montour","BUF","D","54","919.78333333333","4","10","4","6","14","35.90"
"594","Oskar Lindblom","PHI","L","30","387.8","8","6","6","0","14","66.67"
"612","Noah Hanifin","CGY","D","70","1205.6833333333","4","10","4","6","14","28.57"
"711","Ryan Lindgren","NYR","D","60","836.33333333333","1","13","5","8","14","30.43"
"865","Blake Lizotte","L.A","C","65","738.28333333333","2","12","6","6","14","77.78"
"1","Zdeno Chara","BOS","D","68","1164.1166666667","4","9","2","7","13","22.81"
"29","Corey Perry","DAL","R","57","636.11666666667","4","9","5","4","13","61.90"
"35","Nate Thompson","MTL, PHI","C","70","718.41666666667","4","9","5","4","13","61.90"
"36","Joe Pavelski","DAL","C","67","845.28333333333","5","8","4","4","13","41.94"
"96","Artem Anisimov","OTT","C","49","574.68333333333","9","4","3","1","13","76.47"
"115","Riley Nash","CBJ","C","64","671.36666666667","4","9","6","3","13","59.09"
"118","Brandon Sutter","VAN","C","44","493.61666666667","6","7","5","2","13","65.00"
"134","Wayne Simmonds","BUF, N.J","R","68","802.4","3","10","6","4","13","59.09"
"148","Tyler Myers","VAN","D","68","1199.25","4","9","6","3","13","25.49"
"152","Michael Del Zotto","ANA","D","49","765.33333333333","2","11","4","7","13","32.50"
"163","Marco Scandella","BUF, MTL, STL","D","62","937.73333333333","4","9","4","5","13","27.66"
"221","Nicolas Deslauriers","ANA","L","59","562.73333333333","7","6","4","2","13","59.09"
"222","Cody Eakin","VGK, WPG","C","49","580.46666666667","4","9","6","3","13","65.00"
"233","Brenden Dillon","S.J, WSH","D","69","1154.5","1","12","5","7","13","27.08"
"235","Radko Gudas","WSH","D","63","854.6","2","11","3","8","13","27.66"
"292","John Klingberg","DAL","D","58","1032","3","10","5","5","13","38.24"
"306","Josh Archibald","EDM","R","62","648.71666666667","7","6","5","1","13","68.42"
"333","Victor Rask","MIN","C","43","427.61666666667","5","8","3","5","13","65.00"
"360","Connor Murphy","CHI","D","58","1026.5166666667","3","10","6","4","13","30.95"
"386","Olli Maatta","CHI","D","65","1028.7333333333","4","9","4","5","13","27.66"
"415","Colton Sissons","NSH","C","57","648.11666666667","8","5","5","0","13","54.17"
"466","Carson Soucy","MIN","D","55","775.88333333333","6","7","6","1","13","36.11"
"538","Tomas Nosek","VGK","L","67","675.93333333333","7","6","2","4","13","56.52"
"545","Haydn Fleury","CAR","D","45","567.33333333333","4","9","6","3","13","61.90"
"582","Michael Amadio","L.A","C","68","758.06666666667","6","7","3","4","13","48.15"
"702","Philippe Myers","PHI","D","50","807.05","4","9","5","4","13","28.26"
"721","Dillon Dube","CGY","C","45","521.5","5","8","4","4","13","59.09"
"724","Sam Steel","ANA","C","65","824.7","4","9","4","5","13","56.52"
"725","Brett Howden","NYR","C","70","733.13333333333","7","6","3","3","13","54.17"
"755","Filip Hronek","DET","D","65","1099.4833333333","4","9","4","5","13","37.14"
"758","Drake Caggiula","CHI","C","40","436.76666666667","8","5","4","1","13","59.09"
"812","David Kampf","CHI","C","70","776.75","7","6","4","2","13","68.42"
"82","Trevor Lewis","L.A","C","56","603.1","6","6","4","2","12","54.55"
"84","Milan Lucic","CGY","L","68","775.9","3","9","6","3","12","37.50"
"98","Mathieu Perreault","WPG","C, L","49","563.61666666667","5","7","2","5","12","70.59"
"131","Alec Martinez","L.A, VGK","D","51","902.71666666667","3","9","2","7","12","30.77"
"151","Jake Gardiner","CAR","D","68","964.2","2","10","1","9","12","38.71"
"230","Nic Dowd","WSH","C","56","456.21666666667","4","8","2","6","12","54.55"
"417","Jake McCabe","BUF","D","66","1046.0333333333","2","10","5","5","12","33.33"
"474","Carter Verhaeghe","T.B","C","52","461.11666666667","8","4","2","2","12","66.67"
"490","Robert Hagg","PHI","D","49","697","2","10","4","6","12","36.36"
"521","Frederik Gauthier","TOR","C","61","504.9","7","5","3","2","12","70.59"
"573","Nicolas Aube-Kubel","PHI","R","36","363.4","5","7","5","2","12","66.67"
"590","Sam Lafferty","PIT","C","50","443.18333333333","5","7","4","3","12","85.71"
"599","Sammy Blais","STL","L","40","466.61666666667","6","6","4","2","12","75.00"
"602","Pierre Engvall","TOR","L","48","499.45","6","6","5","1","12","60.00"
"620","Vince Dunn","STL","D","71","1016.9833333333","5","7","4","3","12","23.53"
"663","Ivan Provorov","PHI","D","69","1216.2166666667","5","7","4","3","12","22.22"
"697","Matt Roy","L.A","D","70","1122.1666666667","2","10","3","7","12","25.00"
"800","Henri Jokiharju","BUF","D","69","1060.7833333333","3","9","5","4","12","30.77"
"831","Eric Robinson","CBJ","L","50","536","7","5","3","2","12","52.17"
"17","Duncan Keith","CHI","D","61","1099.4833333333","0","11","5","6","11","25.58"
"62","James Neal","EDM","L","55","703.2","5","6","2","4","11","47.83"
"83","Leo Komarov","NYI","C, R","48","522.3","2","9","3","6","11","61.11"
"95","Michael Frolik","BUF, CGY","R","57","616.08333333333","4","7","3","4","11","91.67"
"114","P.K. Subban","N.J","D","68","1157","4","7","4","3","11","30.56"
"181","Antoine Roussel","VAN","L","41","417.46666666667","6","5","3","2","11","50.00"
"398","Matt Grzelcyk","BOS","D","68","994.66666666667","3","8","7","1","11","32.35"
"422","Dominic Toninato","FLA","C","46","471.58333333333","4","7","4","3","11","52.38"
"472","Mattias Janmark","DAL","C","62","726.91666666667","3","8","3","5","11","61.11"
"517","Nikita Zadorov","COL","D","64","982.41666666667","4","7","1","6","11","28.95"
"530","Ryan Carpenter","CHI","C","69","770.18333333333","2","9","4","5","11","50.00"
"536","Melker Karlsson","S.J","C","61","600.53333333333","5","6","2","4","11","61.11"
"542","Sam Bennett","CGY","C","52","592.3","8","3","3","0","11","64.71"
"565","Brendan Lemieux","NYR","L","59","630.41666666667","3","8","5","3","11","57.89"
"613","Rasmus Andersson","CGY","D","70","1154.75","4","7","3","4","11","28.21"
"625","Erik Cernak","T.B","D","67","1003.3","4","7","2","5","11","25.58"
"659","Jacob Larsson","ANA","D","60","881.76666666667","2","9","4","5","11","35.48"
"690","Troy Terry","ANA","C, R","47","572.31666666667","3","8","7","1","11","68.75"
"777","Zach Aston-Reese","PIT","C","57","685.15","4","7","4","3","11","52.38"
"809","Alexandre Texier","CBJ","C","36","425.63333333333","5","6","4","2","11","64.71"
"821","Emil Bemstrom","CBJ","C","56","604.76666666667","4","7","6","1","11","68.75"
"849","Adam Boqvist","CHI","D","41","546.36666666667","4","7","4","3","11","36.67"
"870","Jack Hughes","N.J","C","61","714.5","2","9","7","2","11","64.71"
"9","Mikko Koivu","MIN","C","55","638","3","7","5","2","10","40.00"
"63","Marc-Edouard Vlasic","S.J","D","70","1154.4166666667","3","7","3","4","10","27.03"
"71","Nathan Gerbe","CBJ","C","30","380.68333333333","4","6","3","3","10","76.92"
"75","Andy Greene","N.J, NYI","D","63","982.01666666667","2","8","5","3","10","29.41"
"91","Michael Grabner","ARI","L, R","46","455.1","7","3","2","1","10","66.67"
"135","Nick Holden","VGK","D","61","1000.45","4","6","1","5","10","25.64"
"161","Travis Hamonic","CGY","D","50","860.26666666667","2","8","4","4","10","27.78"
"190","Alex Chiasson","EDM","R","65","692.25","5","5","2","3","10","47.62"
"216","Sami Vatanen","N.J","D","47","727.53333333333","4","6","0","6","10","40.00"
"247","Jordan Weal","MTL","C","49","556.45","6","4","0","4","10","62.50"
"261","Austin Watson","NSH","L","53","542.51666666667","6","4","0","4","10","55.56"
"263","Riley Sheahan","EDM","C","66","667.95","5","5","4","1","10","58.82"
"300","Colin Blackwell","NSH","C","27","289.18333333333","3","7","5","2","10","58.82"
"330","Scott Mayfield","NYI","D","67","1123.45","4","6","4","2","10","27.03"
"355","Jamie Oleksiak","DAL","D","69","1019.45","3","7","4","3","10","33.33"
"376","Hampus Lindholm","ANA","D","55","945.43333333333","1","9","4","5","10","32.26"
"395","Slater Koekkoek","CHI","D","42","633.55","1","9","3","6","10","37.04"
"400","Brendan Leipsic","WSH","L","61","520.71666666667","3","7","4","3","10","47.62"
"402","Esa Lindell","DAL","D","69","1182.2","1","9","5","4","10","22.73"
"405","Mackenzie MacEachern","STL","L","51","448.2","7","3","1","2","10","62.50"
"406","Devin Shore","ANA, CBJ","C","45","481.26666666667","5","5","4","1","10","55.56"
"411","Jordan Martinook","CAR","L","45","440.31666666667","2","8","5","3","10","66.67"
"504","Jonathan Drouin","MTL","L","27","338.61666666667","6","4","2","2","10","76.92"
"532","Jordan Oesterle","ARI","D","58","861.2","3","7","4","3","10","40.00"
"543","Michael Dal Colle","NYI","L","53","601.91666666667","4","6","4","2","10","62.50"
"555","Alex Tuch","VGK","R","42","511.61666666667","5","5","4","1","10","66.67"
"566","Jayce Hawryluk","FLA, OTT","C, R","26","280.85","3","7","4","3","10","90.91"
"621","Travis Dermott","TOR","D","56","871.18333333333","4","6","1","5","10","23.81"
"644","Austin Wagner","L.A","L","65","735.85","5","5","2","3","10","58.82"
"732","Max Jones","ANA","L","59","729.66666666667","7","3","2","1","10","62.50"
"737","Victor Mete","MTL","D","51","757.98333333333","4","6","5","1","10","30.30"
"768","Dylan Gambrell","S.J","C","50","506.83333333333","5","5","2","3","10","47.62"
"34","Brad Richardson","ARI","C, R","59","633.68333333333","5","4","4","0","9","45.00"
"56","Jack Johnson","PIT","D","67","1127.1333333333","1","8","4","4","9","21.95"
"58","Marc Staal","NYR","D","52","747.71666666667","2","7","3","4","9","33.33"
"111","Paul Byron","MTL","L","29","342.25","3","6","4","2","9","69.23"
"112","Sam Gagner","DET, EDM","C","42","495.8","3","6","3","3","9","56.25"
"127","Ryan McDonagh","T.B","D","50","807.73333333333","0","9","7","2","9","26.47"
"150","Luca Sbisa","WPG","D","44","679.16666666667","2","7","1","6","9","33.33"
"202","Dmitry Kulikov","WPG","D","51","919.45","2","7","2","5","9","30.00"
"254","Justin Faulk","STL","D","69","1212.05","4","5","2","3","9","20.93"
"264","Chris Wagner","BOS","R","67","709.71666666667","5","4","3","1","9","42.86"
"307","Travis Boyd","WSH","C","24","249.11666666667","3","6","5","1","9","60.00"
"368","Brad Hunt","MIN","D","59","731.18333333333","5","4","3","1","9","29.03"
"407","Jujhar Khaira","EDM","L","64","677.88333333333","6","3","2","1","9","60.00"
"487","Jacob de la Rose","DET, STL","C, L","50","472.06666666667","2","7","4","3","9","60.00"
"615","Jonas Siegenthaler","WSH","D","64","780.18333333333","2","7","5","2","9","28.13"
"647","Nicolas Roy","VGK","C","28","295.9","4","5","3","2","9","64.29"
"685","Dmytro Timashov","DET, TOR","L","44","368.26666666667","4","5","3","2","9","69.23"
"735","Dante Fabbro","NSH","D","64","1121.1333333333","3","6","3","3","9","21.95"
"757","Nikita Zaitsev","OTT","D","58","1057.9166666667","0","9","7","2","9","27.27"
"781","Mario Ferraro","S.J","D","61","874.8","1","8","3","5","9","28.13"
"869","Kaapo Kakko","NYR","R","66","767.7","7","2","1","1","9","56.25"
"4","Ron Hainsey","OTT","D","64","1067.3833333333","1","7","1","6","8","18.18"
"10","Dan Hamhuis","NSH","D","60","712.48333333333","0","8","6","2","8","29.63"
"14","Jay Bouwmeester","STL","D","56","1025.3166666667","1","7","3","4","8","23.53"
"15","Johnny Boychuk","NYI","D","64","940.11666666667","1","7","4","3","8","34.78"
"66","Kris Russell","EDM","D","55","776.3","0","8","4","4","8","40.00"
"136","Jason Demers","ARI","D","50","871.48333333333","0","8","3","5","8","26.67"
"138","Zack Smith","CHI","C","50","510.43333333333","3","5","3","2","8","61.54"
"173","Matt Martin","NYI","L","55","550.3","5","3","3","0","8","61.54"
"206","Brayden McNabb","VGK","D","71","1154.4666666667","1","7","4","3","8","16.33"
"219","Casey Cizikas","NYI","C","48","548.03333333333","6","2","1","1","8","47.06"
"220","David Savard","CBJ","D","68","1219.2","0","8","4","4","8","17.78"
"267","Erik Gudbranson","ANA, PIT","D","51","841.18333333333","4","4","2","2","8","25.81"
"297","Taylor Fedun","DAL","D","27","348.91666666667","2","6","5","1","8","53.33"
"342","Scott Harrington","CBJ","D","39","513.85","1","7","3","4","8","61.54"
"358","Nathan Beaulieu","WPG","D","38","546.38333333333","1","7","4","3","8","32.00"
"361","Stefan Noesen","PIT, S.J","R","40","424.5","6","2","1","1","8","80.00"
"389","Cody Ceci","TOR","D","56","952.95","1","7","3","4","8","22.86"
"420","Nikolai Prokhorkin","L.A","L","43","488.48333333333","3","5","5","0","8","88.89"
"434","Matthew Benning","EDM","D","43","530.31666666667","1","7","5","2","8","34.78"
"468","Josh Brown","FLA","D","56","714.9","3","5","1","4","8","25.81"
"529","Trevor van Riemsdyk","CAR","D","49","651.61666666667","1","7","2","5","8","36.36"
"628","Brendan Guhle","ANA","D","30","466.01666666667","4","4","1","3","8","44.44"
"632","Christian Fischer","ARI","R","56","600.98333333333","5","3","3","0","8","42.11"
"643","Caleb Jones","EDM","D","43","585.96666666667","4","4","4","0","8","29.63"
"670","Evan Rodrigues","BUF, PIT","C, L","45","440.26666666667","4","4","1","3","8","72.73"
"772","Trevor Moore","L.A, TOR","C, L","42","446.18333333333","5","3","2","1","8","47.06"
"799","Max Comtois","ANA","L","29","326.21666666667","3","5","3","2","8","66.67"
"816","Radim Simek","S.J","D","48","720.3","1","7","4","3","8","36.36"
"841","Filip Zadina","DET","R","28","340.45","4","4","3","1","8","72.73"
"5","Justin Williams","CAR","R","20","216.46666666667","5","2","1","1","7","53.85"
"30","Loui Eriksson","VAN","L","49","516.38333333333","4","3","2","1","7","36.84"
"44","Mike Green","DET, EDM","D","50","887.1","2","5","1","4","7","33.33"
"55","Bobby Ryan","OTT","R","24","256.5","4","3","2","1","7","63.64"
"164","Michael Stone","CGY","D","33","487.73333333333","2","5","3","2","7","38.89"
"229","Nick Jensen","WSH","D","68","1010.75","0","7","3","4","7","17.95"
"250","Patrik Nemeth","DET","D","64","1143.6833333333","1","6","3","3","7","22.58"
"277","Joakim Nordstrom","BOS","C","48","471.43333333333","4","3","2","1","7","70.00"
"289","Anthony Bitetto","WPG","D","51","652.35","0","7","2","5","7","25.93"
"308","Dylan DeMelo","OTT, WPG","D","59","974.78333333333","0","7","4","3","7","18.42"
"311","Tobias Rieder","CGY","C","55","502.91666666667","2","5","4","1","7","77.78"
"315","Andrew Shaw","CHI","C, R","26","297.8","2","5","2","3","7","77.78"
"318","Adam Lowry","WPG","C, L","49","597.61666666667","2","5","2","3","7","46.67"
"373","Ryan Murray","CBJ","D","27","433.71666666667","2","5","4","1","7","53.85"
"385","Mark Jankowski","CGY","C","56","484.5","5","2","1","1","7","70.00"
"444","Kurtis MacDermid","L.A","D","45","553.2","3","4","2","2","7","46.67"
"461","Tyler Motte","VAN","C","34","367.71666666667","4","3","2","1","7","87.50"
"518","Curtis Lazar","BUF","C","38","371.56666666667","3","4","3","1","7","63.64"
"627","Jansen Harkins","WPG","C","29","303.75","2","5","3","2","7","63.64"
"680","Denis Malgin","FLA, TOR","C","44","458.25","2","5","3","2","7","46.67"
"695","Mason Appleton","WPG","C","46","461.7","4","3","2","1","7","58.33"
"696","Markus Nutivaara","CBJ","D","37","564.01666666667","2","5","0","5","7","41.18"
"741","Jordan Kyrou","STL","C","28","292.7","4","3","3","0","7","50.00"
"779","Nicolas Hague","VGK","D","38","567.1","0","7","4","3","7","21.88"
"817","Jan Rutta","T.B","D","33","450.78333333333","1","6","3","3","7","25.93"
"859","Antti Suomela","S.J","C","20","185.28333333333","1","6","2","4","7","70.00"
"876","Joakim Nygard","EDM","L","33","330.08333333333","1","6","3","3","7","53.85"
"883","Gaetan Haas","EDM","C","58","517.88333333333","4","3","2","1","7","58.33"
"117","Brendan Smith","NYR","D","62","551.61666666667","2","4","3","1","6","54.55"
"121","Carl Gunnarsson","STL","D","36","488.28333333333","2","4","3","1","6","28.57"
"124","Robert Bortuzzo","STL","D","42","443.4","2","4","2","2","6","26.09"
"139","Jay Beagle","VAN","C","55","510.31666666667","1","5","3","2","6","60.00"
"143","Zach Bogosian","BUF, T.B","D","27","375.48333333333","1","5","4","1","6","37.50"
"180","Jordie Benn","VAN","D","44","600.91666666667","1","5","4","1","6","28.57"
"200","Calvin de Haan","CHI","D","29","485.31666666667","1","5","2","3","6","31.58"
"225","Gabriel Bourque","WPG","L","52","427.13333333333","2","4","1","3","6","75.00"
"231","Justin Dowling","DAL","C","29","275.5","3","3","3","0","6","60.00"
"246","Greg McKegg","NYR","C","53","447.8","3","3","1","2","6","60.00"
"305","Josh Manson","ANA","D","50","853.01666666667","1","5","1","4","6","21.43"
"324","Nick Shore","TOR, WPG","C","63","481.78333333333","3","3","2","1","6","54.55"
"328","Mike Reilly","MTL, OTT","D","44","669.96666666667","0","6","2","4","6","21.43"
"347","Adam Larsson","EDM","D","49","852.2","1","5","2","3","6","20.69"
"365","Colin Miller","BUF","D","51","758.28333333333","0","6","4","2","6","25.00"
"408","Adam Pelech","NYI","D","38","660.78333333333","1","5","2","3","6","23.08"
"414","Martin Frk","L.A","R","17","201.63333333333","4","2","1","1","6","66.67"
"419","Connor Carrick","N.J","D","29","391.31666666667","1","5","1","4","6","46.15"
"447","Scott Sabourin","OTT","R","35","243.9","2","4","2","2","6","85.71"
"453","Chad Ruhwedel","PIT","D","41","540.48333333333","2","4","0","4","6","30.00"
"571","Vladislav Kamenev","COL","C","38","289.56666666667","1","5","4","1","6","75.00"
"606","Matthew Highmore","CHI","C","36","334.03333333333","2","4","2","2","6","54.55"
"630","Oliver Kylington","CGY","D","48","641.23333333333","1","5","3","2","6","30.00"
"655","Mitchell Stephens","T.B","C","38","349.66666666667","3","3","2","1","6","46.15"
"658","Filip Chlapik","OTT","C","31","267.56666666667","3","3","1","2","6","75.00"
"667","Yakov Trenin","NSH","C","21","201.7","2","4","2","2","6","66.67"
"775","Zack MacEwen","VAN","C","17","160.1","5","1","1","0","6","60.00"
"785","Cody Glass","VGK","C","39","424.21666666667","4","2","1","1","6","54.55"
"787","Casey Mittelstadt","BUF","C","31","325.01666666667","3","3","3","0","6","54.55"
"798","Morgan Frost","PHI","C","20","215.21666666667","1","5","3","2","6","50.00"
"843","Jesperi Kotkaniemi","MTL","C","36","397.78333333333","5","1","0","1","6","50.00"
"850","Rasmus Sandin","TOR","D","28","362.56666666667","1","5","2","3","6","40.00"
"855","Par Lindholm","BOS","C","40","373.05","3","3","2","1","6","54.55"
"867","Joel Kellman","S.J","C","31","326.13333333333","3","3","2","1","6","85.71"
"6","Deryk Engelland","VGK","D","49","681.05","1","4","1","3","5","15.63"
"12","Trevor Daley","DET","D","43","591.35","0","5","2","3","5","31.25"
"13","Frans Nielsen","DET","C","60","630.91666666667","3","2","1","1","5","50.00"
"33","David Backes","ANA, BOS","R","22","195.35","0","5","4","1","5","62.50"
"49","Andrej Sekera","DAL","D","57","865.81666666667","1","4","3","1","5","23.81"
"158","Justin Schultz","PIT","D","46","737.46666666667","3","2","0","2","5","16.67"
"166","Dale Weise","MTL","R","23","202.5","1","4","3","1","5","62.50"
"178","Zac Rinaldo","CGY","C","19","153.1","3","2","1","1","5","83.33"
"212","Brian Dumoulin","PIT","D","28","480.51666666667","0","5","3","2","5","14.71"
"245","Stephen Johns","DAL","D","17","278.33333333333","2","3","1","2","5","50.00"
"252","Jon Merrill","VGK","D","49","783.48333333333","2","3","1","2","5","16.13"
"260","Vladimir Tarasenko","STL","R","10","128.51666666667","1","4","2","2","5","83.33"
"282","Tom Kuhnhackl","NYI","R","28","271.08333333333","3","2","1","1","5","71.43"
"293","Micheal Ferland","VAN","L","14","124.63333333333","1","4","3","1","5","83.33"
"335","Brett Ritchie","BOS","R","27","263.36666666667","2","3","2","1","5","62.50"
"404","Shayne Gostisbehere","PHI","D","42","616.68333333333","2","3","0","3","5","23.81"
"427","Brett Kulak","MTL","D","56","922.7","0","5","3","2","5","14.29"
"437","Joseph Blandisi","PIT","C","21","170.26666666667","2","3","3","0","5","71.43"
"443","Joakim Ryan","L.A","D","35","598.1","1","4","2","2","5","41.67"
"449","Tim Schaller","L.A, VAN","C, L","53","459.1","4","1","0","1","5","50.00"
"486","Adam Erne","DET","L","56","597.98333333333","2","3","3","0","5","55.56"
"519","Mirco Mueller","N.J","D","50","745.26666666667","2","3","1","2","5","21.74"
"652","Mathieu Joseph","T.B","R","37","384.36666666667","4","1","0","1","5","41.67"
"675","Kevin Stenlund","CBJ","C","32","375.18333333333","3","2","1","1","5","41.67"
"698","Sami Niku","WPG","D","17","259.26666666667","0","5","3","2","5","62.50"
"703","Kevin Rooney","N.J","C","49","458.95","2","3","3","0","5","38.46"
"706","Joey Anderson","N.J","R","18","193.41666666667","3","2","1","1","5","71.43"
"714","Libor Hajek","NYR","D","28","407.48333333333","0","5","2","3","5","33.33"
"731","Logan Brown","OTT","C","23","219.5","0","5","3","2","5","45.45"
"759","Patrick Russell","EDM","R","45","464.5","0","5","4","1","5","55.56"
"770","Matt Luff","L.A","R","18","180.63333333333","1","4","2","2","5","71.43"
"793","Gabriel Vilardi","L.A","C","10","112.55","2","3","2","1","5","83.33"
"814","Oscar Fantenberg","VAN","D","36","514.21666666667","1","4","1","3","5","38.46"
"848","Noah Dobson","NYI","D","34","408.3","1","4","2","2","5","31.25"
"851","Karson Kuhlman","BOS","C","25","291.01666666667","0","5","4","1","5","83.33"
"856","Juuso Riikola","PIT","D","36","438.95","1","4","3","1","5","35.71"
"881","Jakob Lilja","CBJ","L","37","359.73333333333","2","3","2","1","5","41.67"
"21","Braydon Coburn","T.B","D","40","510.76666666667","1","3","0","3","4","15.38"
"51","Roman Polak","DAL","D","41","549.08333333333","0","4","0","4","4","30.77"
"76","Bryan Little","WPG","C","7","89.116666666667","1","3","2","1","4","80.00"
"86","Cal Clutterbuck","NYI","R","37","397.1","2","2","1","1","4","50.00"
"145","Colin Wilson","COL","C","9","97.083333333333","0","4","1","3","4","57.14"
"160","Cameron Gaunce","T.B","D","3","34.083333333333","1","3","2","1","4","100.00"
"240","Martin Marincin","TOR","D","26","346.23333333333","1","3","1","2","4","28.57"
"274","Jarred Tinordi","NSH","D","28","411.7","1","3","2","1","4","23.53"
"284","Tim Heed","S.J","D","38","444.2","1","3","1","2","4","40.00"
"322","Logan Shaw","WPG","R","35","231.6","3","1","1","0","4","100.00"
"336","Markus Granlund","EDM","C","34","317.96666666667","3","1","0","1","4","50.00"
"371","Luke Glendening","DET","C","60","714.41666666667","3","1","1","0","4","44.44"
"469","John Hayden","N.J","C","43","398.3","3","1","0","1","4","36.36"
"523","Ross Johnston","NYI","L","32","252.91666666667","3","1","1","0","4","50.00"
"525","Dakota Mermis","N.J","D","10","166.06666666667","1","3","1","2","4","36.36"
"550","Brendan Perlini","CHI, DET","L","40","368.7","1","3","2","1","4","80.00"
"608","Dryden Hunt","FLA","L","21","214.55","0","4","2","2","4","57.14"
"672","Dean Kukan","CBJ","D","33","484.6","0","4","3","1","4","30.77"
"716","Carl Grundstrom","L.A","R","13","155.03333333333","0","4","3","1","4","44.44"
"736","Josh Mahura","ANA","D","11","153.18333333333","1","3","1","2","4","57.14"
"742","Riley Stillman","FLA","D","34","540.26666666667","0","4","2","2","4","20.00"
"783","Morgan Geekie","CAR","C","2","17.8","3","1","0","1","4","100.00"
"822","Drake Batherson","OTT","C, R","23","296.43333333333","2","2","1","1","4","57.14"
"828","Alexander True","S.J","C","12","113.7","0","4","2","2","4","66.67"
"846","Barrett Hayton","ARI","C","20","215.35","1","3","2","1","4","50.00"
"858","Ilya Lyubushkin","ARI","D","51","705.2","0","4","3","1","4","14.81"
"871","Ville Heinola","WPG","D","8","134.16666666667","1","3","0","3","4","50.00"
"24","Brent Seabrook","CHI","D","32","499.96666666667","2","1","0","1","3","17.65"
"64","Justin Abdelkader","DET","L","49","473.76666666667","0","3","2","1","3","50.00"
"68","Vladimir Sobotka","BUF","C","16","198","1","2","1","1","3","33.33"
"69","Niklas Hjalmarsson","ARI","D","27","423.45","1","2","1","1","3","30.00"
"77","Alex Biega","DET","D","49","707.5","0","3","2","1","3","18.75"
"93","Korbinian Holzer","ANA, NSH","D","49","678.35","1","2","0","2","3","16.67"
"122","Yannick Weber","NSH","D","41","547.46666666667","1","2","0","2","3","15.00"
"144","Luke Schenn","T.B","D","25","266.05","1","2","1","1","3","30.00"
"146","Mikkel Boedker","OTT","L","20","166.5","1","2","1","1","3","60.00"
"171","Greg Pateryn","MIN","D","20","257.96666666667","0","3","0","3","3","25.00"
"177","Luke Witkowski","T.B","R","12","103.2","1","2","1","1","3","100.00"
"205","John Moore","BOS","D","24","326.16666666667","2","1","1","0","3","27.27"
"234","Andrew Agozzino","ANA, PIT","L","22","148.08333333333","1","2","2","0","3","42.86"
"236","Matt Irwin","ANA, NSH","D","36","468.51666666667","0","3","1","2","3","23.08"
"370","Matt Tennyson","N.J","D","20","238.8","0","3","0","3","3","18.75"
"379","Phillip Di Giuseppe","NYR","L","20","218.73333333333","1","2","1","1","3","37.50"
"382","Stefan Matteau","CBJ","C","9","105","2","1","0","1","3","60.00"
"431","Josh Anderson","CBJ","R","26","318.01666666667","1","2","1","1","3","30.00"
"450","Danny DeKeyser","DET","D","8","140.48333333333","0","3","1","2","3","50.00"
"489","Valentin Zykov","VGK","L","15","160.06666666667","0","3","1","2","3","60.00"
"492","Nic Petan","TOR","C","16","163.5","0","3","2","1","3","60.00"
"569","Andreas Englund","OTT","D","24","233.98333333333","0","3","3","0","3","75.00"
"586","Christoffer Ehn","DET","C","54","485.7","2","1","1","0","3","100.00"
"600","Dylan Sikura","CHI","R","9","88.433333333333","1","2","1","1","3","75.00"
"604","Jake Evans","MTL","C","13","119.51666666667","2","1","0","1","3","75.00"
"664","Dennis Gilbert","CHI","D","21","291.95","1","2","0","2","3","30.00"
"678","Aleksi Saarela","FLA","C","9","104.11666666667","2","1","1","0","3","75.00"
"681","Mikhail Vorobyev","PHI","C","20","191.56666666667","1","2","2","0","3","60.00"
"689","Rudolfs Balcers","OTT","L","15","152.91666666667","1","2","2","0","3","50.00"
"701","Adam Brooks","TOR","C","7","52.066666666667","0","3","2","1","3","100.00"
"713","Julien Gauthier","CAR, NYR","R","17","137.05","0","3","1","2","3","50.00"
"726","Kieffer Bellows","NYI","L","8","82.15","2","1","0","1","3","75.00"
"733","Andrew Peeke","CBJ","D","22","293.8","1","2","1","1","3","27.27"
"738","Givani Smith","DET","R","21","172.55","2","1","1","0","3","100.00"
"790","Jesper Boqvist","N.J","C","35","344.81666666667","3","0","0","0","3","75.00"
"808","Erik Brannstrom","OTT","D","31","385.68333333333","0","3","2","1","3","23.08"
"815","Calle Rosen","COL, TOR","D","12","151.66666666667","0","3","0","3","3","50.00"
"839","Isac Lundestrom","ANA","C","15","166.4","0","3","2","1","3","42.86"
"156","Cody Goloubef","DET, OTT","D","26","346.83333333333","1","1","0","1","2","15.38"
"176","Mark Barberio","COL","D","21","265.76666666667","0","2","2","0","2","18.18"
"211","Brandon Pirri","VGK","C","16","172.11666666667","0","2","1","1","2","100.00"
"256","Nick Bjugstad","PIT","C","13","133.13333333333","1","1","1","0","2","33.33"
"301","Matthew Peca","MTL, OTT","C","14","135.96666666667","0","2","1","1","2","50.00"
"304","Scott Wilson","BUF","L","6","68.45","1","1","1","0","2","66.67"
"312","Fredrik Claesson","N.J","D","5","67.3","1","1","1","0","2","50.00"
"331","Tomas Jurco","EDM","R","12","115.71666666667","0","2","2","0","2","50.00"
"339","Xavier Ouellet","MTL","D","12","150.93333333333","0","2","2","0","2","33.33"
"421","Charles Hudon","MTL","L","15","155.06666666667","1","1","0","1","2","200.00"
"464","Connor Clifton","BOS","D","31","416.58333333333","2","0","0","0","2","11.76"
"526","Nathan Walker","STL","L","5","55.15","1","1","1","0","2","100.00"
"527","Joel Hanley","DAL","D","8","87.15","0","2","1","1","2","50.00"
"531","Christian Folin","MTL","D","16","215.6","1","1","0","1","2","22.22"
"605","Jacob Middleton","S.J","D","10","97.1","0","2","2","0","2","66.67"
"607","Joe Hicketts","DET","D","6","92.9","0","2","0","2","2","66.67"
"640","Nicholas Merkley","N.J","R","4","41.633333333333","1","1","1","0","2","100.00"
"650","Jeremy Lauzon","BOS","D","19","252.05","1","1","0","1","2","22.22"
"657","Zach Senyshyn","BOS","R","4","33.716666666667","0","2","1","1","2","100.00"
"668","Austin Czarnik","CGY","C","8","70.2","1","1","0","1","2","100.00"
"688","Christian Jaros","OTT","D","13","123.93333333333","0","2","1","1","2","50.00"
"715","Rasmus Asplund","BUF","C","29","253.28333333333","1","1","0","1","2","28.57"
"739","Nick Caamano","DAL","R","12","114.48333333333","1","1","0","1","2","50.00"
"740","Connor Bunnaman","PHI","C","21","190.26666666667","1","1","0","1","2","20.00"
"743","Noah Gregor","S.J","C","28","267.7","2","0","0","0","2","18.18"
"751","Michael McLeod","N.J","C","12","117.35","0","2","2","0","2","33.33"
"776","Gerald Mayhew","MIN","C","13","132.78333333333","2","0","0","0","2","25.00"
"805","Ryan Poehling","MTL","C","27","254.73333333333","1","1","1","0","2","50.00"
"827","Adam Johnson","PIT","C","7","46.65","1","1","1","0","2","66.67"
"842","Martin Kaut","COL","R","9","83.066666666667","1","1","1","0","2","66.67"
"854","Joel Persson","EDM","D","13","193.38333333333","0","2","0","2","2","28.57"
"862","Logan O'Connor","COL","R","16","128.5","2","0","0","0","2","40.00"
"863","Taro Hirose","DET","L","26","257.2","2","0","0","0","2","66.67"
"864","Nico Sturm","MIN","C","6","65.566666666667","0","2","0","2","2","66.67"
"40","Andrew Ladd","NYI","L","4","46.35","1","0","0","0","1","50.00"
"52","Troy Brouwer","STL","R","13","118.76666666667","1","0","0","0","1","25.00"
"85","Chris Stewart","PHI","R","16","122.88333333333","0","1","1","0","1","33.33"
"137","Micheal Haley","NYR","C","22","120","1","0","0","0","1","100.00"
"159","Aaron Ness","ARI","D","24","288.08333333333","0","1","1","0","1","7.69"
"183","Brian Lashoff","DET","D","9","118.05","0","1","0","1","1","50.00"
"232","Brandon Manning","EDM","D","9","97.033333333333","1","0","0","0","1","100.00"
"257","Derek Forbort","CGY, L.A","D","20","319.46666666667","0","1","0","1","1","20.00"
"281","Jani Hakanpaa","ANA","D","5","80.6","1","0","0","0","1","50.00"
"285","Sam Carrick","ANA","C","9","107.21666666667","0","1","0","1","1","33.33"
"296","Ben Street","N.J","C","3","23.916666666667","0","1","0","1","1","100.00"
"298","Cory Conacher","T.B","C","4","41.1","0","1","0","1","1","100.00"
"313","Nick Seeler","CHI, MIN","D","12","133.61666666667","0","1","0","1","1","50.00"
"317","T.J. Tynan","COL","C","16","123.43333333333","0","1","1","0","1","50.00"
"323","Andy Andreoff","PHI","C","14","119.35","0","1","1","0","1","33.33"
"325","Alan Quine","CGY","C","9","87.4","1","0","0","0","1","100.00"
"340","Miikka Salomaki","NSH","R","5","57.45","1","0","0","0","1","50.00"
"378","Pontus Aberg","TOR","L","5","42.55","0","1","0","1","1","100.00"
"380","Brendan Gaunce","BOS","C","1","9.1666666666667","0","1","1","0","1","100.00"
"426","Gemel Smith","T.B","C","3","25.483333333333","1","0","0","0","1","100.00"
"432","Paul LaDue","L.A","D","2","25.1","0","1","0","1","1","inf"
"442","Christian Djoos","ANA, WSH","D","11","160.26666666667","0","1","1","0","1","16.67"
"448","Buddy Robinson","CGY","R","5","58.583333333333","1","0","0","0","1","100.00"
"467","Jonny Brodzinski","S.J","C","3","20.85","0","1","1","0","1","50.00"
"476","Peter Cehlarik","BOS","L","3","31.316666666667","0","1","1","0","1","100.00"
"494","Carl Dahlstrom","WPG","D","15","204.03333333333","0","1","0","1","1","33.33"
"524","Colby Cave","EDM","C","11","94.866666666667","1","0","0","0","1","100.00"
"533","Patrick Brown","VGK","C","1","9.5833333333333","1","0","0","0","1","100.00"
"534","Daniel Carr","NSH","L","11","110.71666666667","1","0","0","0","1","25.00"
"572","Ryan MacInnis","CBJ","C","10","92.216666666667","0","1","0","1","1","50.00"
"574","Maxim Letunov","S.J","C","3","27.233333333333","1","0","0","0","1","100.00"
"581","Mark Friedman","PHI","D","6","80.533333333333","0","1","1","0","1","50.00"
"592","Clark Bishop","CAR","C","5","36.833333333333","0","1","1","0","1","100.00"
"595","Anton Lindholm","COL","D","4","44.833333333333","0","1","0","1","1","33.33"
"596","Anthony Angello","PIT","C","8","45.05","1","0","0","0","1","50.00"
"611","Cole Bardreau","NYI","C","10","80.283333333333","0","1","1","0","1","100.00"
"634","David Kase","PHI","R","6","57.033333333333","1","0","0","0","1","50.00"
"649","Daniel Sprong","ANA","R","8","96.3","0","1","1","0","1","25.00"
"654","Kyle Capobianco","ARI","D","9","120.56666666667","1","0","0","0","1","25.00"
"676","J.C. Beaudin","OTT","C","22","180.91666666667","0","1","0","1","1","20.00"
"677","Lukas Vejdemo","MTL","C","7","54.95","1","0","0","0","1","50.00"
"686","Niko Mikkola","STL","D","5","67.283333333333","0","1","0","1","1","25.00"
"700","Mason Marchment","TOR","L","4","31.633333333333","0","1","1","0","1","100.00"
"722","Tyler Benson","EDM","L","7","67.883333333333","0","1","1","0","1","50.00"
"727","Carsen Twarynski","PHI","L","15","154.48333333333","1","0","0","0","1","50.00"
"729","Tim Gettinger","NYR","L","2","15.733333333333","0","1","0","1","1","100.00"
"744","Dennis Cholowski","DET","D","36","559.61666666667","0","1","0","1","1","7.69"
"750","Vitaly Abramov","OTT","R","2","11.566666666667","1","0","0","0","1","100.00"
"761","Egor Korshkov","TOR","R","1","10.133333333333","1","0","0","0","1","100.00"
"763","Lucas Carlsson","CHI","D","6","79.833333333333","0","1","0","1","1","16.67"
"771","Mathieu Olivier","NSH","R","8","60.366666666667","0","1","1","0","1","50.00"
"774","Gage Quinney","VGK","C","3","28.183333333333","0","1","1","0","1","50.00"
"782","Cale Fleury","MTL","D","41","549.43333333333","1","0","0","0","1","6.67"
"786","Mikey Anderson","L.A","D","6","95.066666666667","1","0","0","0","1","20.00"
"791","Klim Kostin","STL","C","4","34.066666666667","1","0","0","0","1","100.00"
"795","Jack Studnicka","BOS","C","2","22.183333333333","0","1","1","0","1","50.00"
"803","Timothy Liljegren","TOR","D","11","105.41666666667","0","1","0","1","1","33.33"
"807","Lias Andersson","NYR","C","17","126.38333333333","0","1","0","1","1","50.00"
"819","Eetu Luostarinen","CAR","C","8","78.9","0","1","1","0","1","100.00"
"820","Alexander Volkov","T.B","R","9","90.75","0","1","1","0","1","100.00"
"823","Jonathan Davidsson","OTT","R","6","32.6","0","1","1","0","1","100.00"
"829","Zach Whitecloud","VGK","D","16","209.93333333333","0","1","0","1","1","12.50"
"830","Kiefer Sherwood","ANA","R","10","120.85","0","1","1","0","1","50.00"
"832","Joel L'Esperance","DAL","R","3","18.466666666667","1","0","0","0","1","100.00"
"835","Martin Fehervary","WSH","D","6","87.416666666667","0","1","0","1","1","16.67"
"847","Liam Foudy","CBJ","C","2","27.683333333333","0","1","0","1","1","100.00"
"852","Jordan Gross","ARI","D","2","30.733333333333","0","1","0","1","1","33.33"
"860","David Gustafsson","WPG","C","22","132.78333333333","1","0","0","0","1","50.00"
"877","Lean Bergmann","S.J","C","12","98.016666666667","0","1","1","0","1","100.00"
"878","Joel Kiviranta","DAL","L","11","114.58333333333","1","0","0","0","1","100.00"
"18","Jonathan Ericsson","DET","D","18","226.11666666667","0","0","0","0","0","0.00"
"99","Mark Letestu","WPG","C","7","66.266666666667","0","0","0","0","0","0.00"
"101","Karl Alzner","MTL","D","4","51.516666666667","0","0","0","0","0","0.00"
"103","Steven Kampfer","BOS","D","10","125.95","0","0","0","0","0","0.00"
"104","Paul Carey","BOS","C","1","5.85","0","0","0","0","0","-"
"179","Dalton Prout","S.J","D","2","24.683333333333","0","0","0","0","0","0.00"
"217","Jordan Szwarz","OTT","R","3","14.65","0","0","0","0","0","-"
"223","Kevin Connauton","COL","D","4","53.183333333333","0","0","0","0","0","-"
"224","Gabriel Dumont","MIN","C","3","33.833333333333","0","0","0","0","0","-"
"251","Dalton Smith","BUF","L","1","1.4333333333333","0","0","0","0","0","0.00"
"272","Dylan McIlrath","DET","D","16","192.2","0","0","0","0","0","0.00"
"278","Michael Chaput","ARI","C","2","18.566666666667","0","0","0","0","0","-"
"288","Kevin Gravel","TOR","D","3","31.05","0","0","0","0","0","-"
"290","Brandon Davidson","CGY, S.J","D","12","145.36666666667","0","0","0","0","0","0.00"
"291","Zach Trotman","PIT","D","8","104.7","0","0","0","0","0","0.00"
"295","Michael Sgarbossa","WSH","C","2","16.216666666667","0","0","0","0","0","-"
"299","Brian Gibbons","CAR","C","15","134.43333333333","0","0","0","0","0","0.00"
"309","Tyler Graovac","VAN","C","8","43.233333333333","0","0","0","0","0","-"
"320","Steven Fogarty","NYR","C","7","38.75","0","0","0","0","0","-"
"354","Sven Baertschi","VAN","L","6","61.15","0","0","0","0","0","-"
"393","Derrick Pouliot","STL","D","2","16.666666666667","0","0","0","0","0","-"
"412","Boo Nieves","NYR","C","4","27.1","0","0","0","0","0","0.00"
"423","Trevor Carrick","S.J","D","3","15.85","0","0","0","0","0","-"
"428","Thomas Di Pauli","PIT","C","2","11.966666666667","0","0","0","0","0","-"
"433","Jake Bischoff","VGK","D","4","57.383333333333","0","0","0","0","0","0.00"
"436","Riley Barber","MTL","R","9","73.8","0","0","0","0","0","-"
"445","Ashton Sautner","VAN","D","1","2.8166666666667","0","0","0","0","0","-"
"446","Jayson Megna","COL","C","8","52.866666666667","0","0","0","0","0","0.00"
"455","Anton Blidh","BOS","L","7","69.383333333333","0","0","0","0","0","0.00"
"457","John Gilmour","BUF","D","4","61.65","0","0","0","0","0","-"
"459","Tyler Lewington","WSH","D","6","58.433333333333","0","0","0","0","0","0.00"
"465","Luke Johnson","MIN","C","3","30.2","0","0","0","0","0","-"
"483","Marko Dano","CBJ","L","3","21.3","0","0","0","0","0","-"
"491","Steven Santini","NSH","D","2","18.516666666667","0","0","0","0","0","0.00"
"493","Gustav Olofsson","MTL","D","3","24.316666666667","0","0","0","0","0","-"
"495","Justin Bailey","VAN","R","2","10.65","0","0","0","0","0","-"
"512","Samuel Morin","PHI","D","1","12.533333333333","0","0","0","0","0","-"
"522","Jean-Sebastien Dea","BUF","C","3","22.366666666667","0","0","0","0","0","-"
"562","Nikolay Goldobin","VAN","R","1","8.6166666666667","0","0","0","0","0","-"
"564","John Quenneville","CHI","C","9","91.233333333333","0","0","0","0","0","0.00"
"570","Josh Jacobs","N.J","D","2","32.5","0","0","0","0","0","0.00"
"580","Jake Walman","STL","D","1","11.066666666667","0","0","0","0","0","0.00"
"583","William Lagesson","EDM","D","8","80.333333333333","0","0","0","0","0","0.00"
"585","Chase De Leo","ANA","C","1","14.616666666667","0","0","0","0","0","-"
"588","Austin Poganski","STL","R","1","5.9","0","0","0","0","0","-"
"593","CJ Suess","WPG","L","1","6.4333333333333","0","0","0","0","0","-"
"622","Anthony Richard","NSH","C","1","4.1666666666667","0","0","0","0","0","-"
"631","Evgeny Svechnikov","DET","L","4","30.2","0","0","0","0","0","-"
"633","Keegan Kolesar","VGK","R","1","12.016666666667","0","0","0","0","0","-"
"665","Gabriel Carlsson","CBJ","D","6","60.666666666667","0","0","0","0","0","0.00"
"679","Colton White","N.J","D","6","75.4","0","0","0","0","0","0.00"
"682","Christian Wolanin","OTT","D","3","46.916666666667","0","0","0","0","0","0.00"
"683","Alexandre Carrier","NSH","D","3","32.2","0","0","0","0","0","0.00"
"692","Brett Seney","N.J","L","2","19.866666666667","0","0","0","0","0","-"
"694","Cameron Hughes","BOS","C","1","9.3","0","0","0","0","0","-"
"699","Kole Sherwood","CBJ","R","3","19.916666666667","0","0","0","0","0","-"
"709","Maxime Lajoie","OTT","D","6","45.1","0","0","0","0","0","0.00"
"723","Kale Clague","L.A","D","4","52.083333333333","0","0","0","0","0","0.00"
"728","Beck Malenstyn","WSH","L","3","23.05","0","0","0","0","0","-"
"730","Trent Frederic","BOS","C","2","12.85","0","0","0","0","0","-"
"747","Henrik Borgstrom","FLA","C","4","40.933333333333","0","0","0","0","0","-"
"752","Tage Thompson","BUF","C","1","6.9833333333333","0","0","0","0","0","-"
"754","German Rubtsov","PHI","C","4","27.183333333333","0","0","0","0","0","-"
"762","Janne Kuokkanen","N.J","L","1","11.8","0","0","0","0","0","-"
"764","Otto Koivula","NYI","L","12","93.616666666667","0","0","0","0","0","0.00"
"765","Brandon Hagel","CHI","L","1","11.8","0","0","0","0","0","0.00"
"766","Calvin Thurkauf","CBJ","C","3","24.016666666667","0","0","0","0","0","-"
"767","Joachim Blichfeld","S.J","R","3","37.6","0","0","0","0","0","-"
"769","Rhett Gardner","DAL","C","8","69.666666666667","0","0","0","0","0","0.00"
"773","Brennan Menell","MIN","D","5","62.266666666667","0","0","0","0","0","0.00"
"780","Conor Timmins","COL","D","2","18.25","0","0","0","0","0","0.00"
"784","Jaret Anderson-Dolan","L.A","C","4","40.216666666667","0","0","0","0","0","-"
"788","Urho Vaakanainen","BOS","D","5","74.583333333333","0","0","0","0","0","0.00"
"797","Jason Robertson","DAL","L","3","32.35","0","0","0","0","0","0.00"
"804","Josh Norris","OTT","C","3","41.85","0","0","0","0","0","0.00"
"818","Gustav Lindstrom","DET","D","16","224.2","0","0","0","0","0","0.00"
"824","Max Veronneau","OTT","R","4","32.85","0","0","0","0","0","-"
"825","Sheldon Dries","COL","C","5","33.85","0","0","0","0","0","-"
"833","Lukas Radil","S.J","C","14","127","0","0","0","0","0","0.00"
"834","Oliver Wahlstrom","NYI","R","9","83.866666666667","0","0","0","0","0","0.00"
"840","Nicolas Beaudin","CHI","D","1","16.983333333333","0","0","0","0","0","0.00"
"853","Lawrence Pilut","BUF","D","13","185.21666666667","0","0","0","0","0","0.00"
"861","Otto Leskinen","MTL","D","5","50.766666666667","0","0","0","0","0","0.00"
"866","Danil Yurtaykin","S.J","L","4","46.316666666667","0","0","0","0","0","0.00"
"872","Tobias Bjornfot","L.A","D","3","35.9","0","0","0","0","0","-"
"874","Alexander Yelesin","CGY","D","4","48.5","0","0","0","0","0","0.00"
"875","Anton Wedin","CHI","L","4","35.85","0","0","0","0","0","0.00"
"879","Andrei Chibisov","WPG","R","2","14.9","0","0","0","0","0","-"
"880","Joona Luoto","WPG","L","16","103.51666666667","0","0","0","0","0","-"
"882","Nikolai Knyzhov","S.J","D","3","32.283333333333","0","0","0","0","0","-"