"","Player","Team","Position","GP","TOI","Goals","Total Assists","First Assists","Second Assists","Total Points","IPP"
"230","Johnny Gaudreau","CGY","L","82","1200.9666666667","26","46","37","9","72","75.00"
"616","Auston Matthews","TOR","C","73","1175.3833333333","38","28","16","12","66","75.00"
"613","Matthew Tkachuk","CGY","L","82","1181.7666666667","26","38","25","13","64","69.57"
"587","Kirill Kaprizov","MIN","L","81","1149.9166666667","25","37","26","11","62","83.78"
"560","Mitchell Marner","TOR","C, R","72","1054.9166666667","22","39","22","17","61","78.21"
"484","Michael Bunting","TOR","L","79","1095.05","21","37","22","15","58","65.91"
"516","Connor McDavid","EDM","C","80","1327.8166666667","22","36","24","12","58","79.45"
"96","Steven Stamkos","T.B","C","81","1072.1333333333","22","33","24","9","55","82.09"
"442","Leon Draisaitl","EDM","C","80","1284.7166666667","26","28","18","10","54","80.60"
"194","Vladimir Tarasenko","STL","R","75","976.56666666667","26","27","13","14","53","82.81"
"449","Kevin Fiala","MIN","L","82","1036.2","23","30","21","9","53","80.30"
"521","Timo Meier","S.J","R","77","1172.3166666667","20","33","18","15","53","82.81"
"754","Jason Robertson","DAL","L","74","1078.35","22","30","14","16","52","76.47"
"261","Jonathan Huberdeau","FLA","C, L","80","1009.15","17","33","19","14","50","76.92"
"392","Ryan Hartman","MIN","R","82","1119.8833333333","27","23","17","6","50","65.79"
"408","Nathan MacKinnon","COL","C","65","1034.0833333333","23","27","19","8","50","73.53"
"658","Jordan Kyrou","STL","C","74","1019.9666666667","22","28","22","6","50","83.33"
"667","Jesper Bratt","N.J","L","76","1033.1166666667","21","29","15","14","50","83.33"
"81","Patrick Kane","CHI","R","78","1298","15","34","23","11","49","75.38"
"377","Jake Guentzel","PIT","L","76","1156.8833333333","25","24","15","9","49","77.78"
"752","Robert Thomas","STL","C","72","1001.4166666667","12","37","24","13","49","69.01"
"17","Joe Pavelski","DAL","C","82","1162.4666666667","14","34","20","14","48","72.73"
"19","Alex Ovechkin","WSH","L","77","1128.55","24","24","14","10","48","73.85"
"107","Roman Josi","NSH","D","80","1570.5666666667","10","38","23","15","48","58.54"
"141","Nazem Kadri","COL","C","71","963.71666666667","16","32","22","10","48","80.00"
"388","Andre Burakovsky","COL","L","80","1100.8833333333","18","30","18","12","48","68.57"
"575","Artemi Panarin","NYR","L","75","1136.1833333333","13","35","23","12","48","85.71"
"137","Matt Duchene","NSH","C","78","1123.65","21","26","15","11","47","69.12"
"199","Jeff Skinner","BUF","L","80","1088.15","25","22","19","3","47","74.60"
"271","J.T. Miller","VAN","C","80","1152.4833333333","19","28","12","16","47","81.03"
"412","Elias Lindholm","CGY","C","82","1144.3166666667","25","22","11","11","47","55.29"
"452","Dylan Larkin","DET","C","71","1059.7333333333","22","25","17","8","47","81.03"
"585","Conor Garland","VAN","R","77","1075.6666666667","17","30","20","10","47","79.66"
"380","Carter Verhaeghe","FLA","C","78","1076.0666666667","21","25","14","11","46","77.97"
"512","Kyle Connor","WPG","L","79","1241.15","28","18","10","8","46","83.64"
"524","Mikko Rantanen","COL","R","75","1172.4833333333","17","29","17","12","46","54.12"
"673","Tage Thompson","BUF","R","78","1044.1","24","22","12","10","46","70.77"
"311","Filip Forsberg","NSH","L","69","932.31666666667","26","19","12","7","45","77.59"
"464","Ivan Barbashev","STL","C","81","1089.5666666667","17","28","19","9","45","75.00"
"348","Alexander Kerfoot","TOR","C","82","1055.5","11","32","16","16","43","68.25"
"441","Sam Reinhart","FLA","C","78","1006","14","29","19","10","43","68.25"
"461","David Pastrnak","BOS","R","72","992.88333333333","22","21","16","5","43","70.49"
"772","Cale Makar","COL","D","77","1464.3833333333","13","30","16","14","43","49.43"
"46","Brad Marchand","BOS","L","70","908.08333333333","18","24","14","10","42","80.77"
"176","Mats Zuccarello","MIN","C, R","70","983.83333333333","16","26","19","7","42","67.74"
"317","Chandler Stephenson","VGK","C","79","1137.7166666667","11","31","12","19","42","68.85"
"591","Troy Terry","ANA","C, R","75","1122.3166666667","23","19","9","10","42","77.78"
"376","Pavel Buchnevich","STL","L","73","983.71666666667","15","26","10","16","41","65.08"
"534","Travis Konecny","PHI","C, R","79","1082.1166666667","12","29","22","7","41","78.85"
"631","Clayton Keller","ARI","C, R","67","999.91666666667","18","23","14","9","41","73.21"
"826","Brady Tkachuk","OTT","L","79","1133.7833333333","15","26","20","6","41","73.21"
"202","Taylor Hall","BOS","L","81","1037.1166666667","10","30","19","11","40","67.80"
"276","Phillip Danault","L.A","C, L","79","1049.7666666667","24","16","7","9","40","75.47"
"446","William Nylander","TOR","C, R","81","1124.3","18","22","19","3","40","72.73"
"457","Nick Schmaltz","ARI","C","63","900.15","14","26","21","5","40","76.92"
"603","Mason Marchment","FLA","L","54","701.43333333333","15","25","11","14","40","78.43"
"908","Trevor Zegras","ANA","C","75","1066.2333333333","12","28","17","11","40","80.00"
"29","Sidney Crosby","PIT","C","69","1049.9833333333","15","24","16","8","39","70.91"
"135","John Tavares","TOR","C","79","1112.1833333333","15","24","11","13","39","68.42"
"264","Mika Zibanejad","NYR","C","81","1101.75","12","27","18","9","39","70.91"
"306","Tomas Hertl","S.J","C","82","1189.25","18","21","14","7","39","65.00"
"447","Nikolaj Ehlers","WPG","L","62","911.41666666667","20","19","14","5","39","70.91"
"627","Alex DeBrincat","CHI","L","82","1256.6666666667","18","21","10","11","39","66.10"
"265","Mark Scheifele","WPG","C","67","1084.5333333333","17","21","12","9","38","69.09"
"405","Tyler Bertuzzi","DET","L","68","1018.3333333333","18","20","10","10","38","71.70"
"409","Aleksander Barkov","FLA","C","67","884.73333333333","15","23","14","9","38","70.37"
"528","Sebastian Aho","CAR","C, R","79","999.9","15","23","15","8","38","73.08"
"739","Nico Hischier","N.J","C","70","958.53333333333","13","25","16","9","38","80.85"
"838","Andrei Svechnikov","CAR","R","78","1030.8","16","22","15","7","38","69.09"
"121","Cam Atkinson","PHI","R","73","924.03333333333","16","21","17","4","37","74.00"
"136","Victor Hedman","T.B","D","82","1470.45","11","26","11","15","37","48.05"
"166","Erik Haula","BOS","L","78","991.65","15","22","12","10","37","71.15"
"183","Evgeny Kuznetsov","WSH","C","79","1118.1","13","24","14","10","37","66.07"
"209","Nino Niederreiter","CAR","R","75","979.11666666667","18","19","11","8","37","62.71"
"296","Brady Skjei","CAR","D","82","1436.2333333333","9","28","16","12","37","51.39"
"507","Andrew Mangiapane","CGY","L","82","989.93333333333","23","14","8","6","37","75.51"
"542","Roope Hintz","DAL","C, L","80","1059.4","24","13","11","2","37","61.67"
"62","Alex Killorn","T.B","C, L","82","1044.35","14","22","12","10","36","75.00"
"188","Justin Faulk","STL","D","76","1425.6166666667","13","23","7","16","36","39.56"
"189","Brock Nelson","NYI","C","72","970.01666666667","21","15","11","4","36","75.00"
"200","Zach Hyman","EDM","C, L","76","1098.0333333333","19","17","13","4","36","76.60"
"282","Jonathan Marchessault","VGK","C","76","1097.7","18","18","14","4","36","76.60"
"292","Morgan Rielly","TOR","D","82","1474.5166666667","7","29","17","12","36","40.00"
"417","Valeri Nichushkin","COL","R","62","866.43333333333","15","21","13","8","36","67.92"
"37","Kris Letang","PIT","D","78","1505.6","6","29","18","11","35","49.30"
"258","Nikita Kucherov","T.B","R","47","704.93333333333","14","21","14","7","35","70.00"
"481","Viktor Arvidsson","L.A","L","66","892.08333333333","12","23","15","8","35","76.09"
"539","Mathew Barzal","NYI","C","73","1040.5333333333","12","23","13","10","35","77.78"
"546","Jack Roslovic","CBJ","C","81","939.55","17","18","12","6","35","72.92"
"31","Anze Kopitar","L.A","C","81","1179.4166666667","12","22","14","8","34","73.91"
"55","Claude Giroux","FLA, PHI","C, R","75","1034.2833333333","13","21","9","12","34","72.34"
"263","Ryan Strome","NYR","C","74","1039.7833333333","11","23","13","10","34","61.82"
"437","Frederick Gaudreau","MIN","C","76","905.81666666667","12","22","11","11","34","69.39"
"629","Patrik Laine","CBJ","L","56","805.88333333333","14","20","10","10","34","80.95"
"710","Trevor Moore","L.A","C","81","1029.8333333333","8","26","16","10","34","72.34"
"749","Nick Suzuki","MTL","C","82","1209.7666666667","9","25","12","13","34","72.34"
"960","Lucas Raymond","DET","L","82","1172.2666666667","16","18","8","10","34","65.38"
"14","Patrice Bergeron","BOS","C","73","891.18333333333","14","19","10","9","33","67.35"
"58","Phil Kessel","ARI","C, R","82","1077.75","5","28","15","13","33","66.00"
"223","Ondrej Palat","T.B","L","77","1016.1166666667","14","19","11","8","33","62.26"
"289","Yanni Gourde","SEA","C","74","1028.3833333333","14","19","16","3","33","78.57"
"379","Anthony Duclair","FLA","L","74","879.83333333333","18","15","13","2","33","57.89"
"479","Devon Toews","COL","D","66","1291.5166666667","7","26","7","19","33","41.77"
"664","Pierre-Luc Dubois","WPG","L","81","1190.35","9","24","14","10","33","62.26"
"22","Blake Wheeler","WPG","R","65","973.2","12","20","14","6","32","74.42"
"28","Paul Stastny","WPG","C","71","987.8","14","18","11","7","32","60.38"
"104","Jordan Eberle","SEA","C, R","79","1114.2666666667","16","16","9","7","32","68.09"
"131","Ryan O'Reilly","STL","C","78","1053.0833333333","9","23","14","9","32","69.57"
"147","Chris Kreider","NYR","L","81","1075.3666666667","20","12","7","5","32","65.31"
"158","Craig Smith","BOS","C","74","920.4","16","16","11","5","32","72.73"
"260","Gabriel Landeskog","COL","L","51","767.85","16","16","10","6","32","66.67"
"318","Shayne Gostisbehere","ARI","D","82","1420.55","12","20","8","12","32","55.17"
"364","Andreas Johnsson","N.J","L","71","909.18333333333","11","21","18","3","32","61.54"
"381","Oliver Bjorkstrand","CBJ","R","80","1098.45","16","16","13","3","32","78.05"
"385","Andrew Copp","NYR, WPG","C","72","991.81666666667","14","18","8","10","32","69.57"
"431","Conor Sheary","WSH","L","71","893.6","14","18","10","8","32","82.05"
"443","Sam Bennett","FLA","C","71","930.06666666667","19","13","10","3","32","55.17"
"497","Victor Olofsson","BUF","L","72","902.18333333333","10","22","14","8","32","80.00"
"535","Dylan Strome","CHI","C","69","977.86666666667","17","15","9","6","32","69.57"
"620","Adam Fox","NYR","D","78","1367.9666666667","8","24","11","13","32","51.61"
"761","Martin Necas","CAR","C","78","973.08333333333","10","22","15","7","32","68.09"
"880","Yegor Sharangovich","N.J","C","76","1023.1833333333","16","16","11","5","32","59.26"
"920","Jack Hughes","N.J","C","49","749.96666666667","16","16","10","6","32","74.42"
"963","Seth Jarvis","CAR","C","68","821.05","14","18","10","8","32","66.67"
"966","Dawson Mercer","N.J","C","82","1124.9","14","18","16","2","32","55.17"
"83","Evgenii Dadonov","VGK","R","78","1006.05","12","19","15","4","31","62.00"
"139","Brayden Schenn","STL","C","62","865.76666666667","13","18","13","5","31","64.58"
"234","Vincent Trocheck","CAR","C","81","992.21666666667","11","20","9","11","31","64.58"
"403","Artturi Lehkonen","COL, MTL","L","74","869.35","14","17","12","5","31","83.78"
"418","Max Domi","CAR, CBJ","C","72","828.33333333333","9","22","15","7","31","67.39"
"566","Jake DeBrusk","BOS","L","77","952.43333333333","17","14","8","6","31","77.50"
"689","Ross Colton","T.B","C","79","864.23333333333","20","11","7","4","31","81.58"
"708","Tanner Jeannot","NSH","L","81","993.45","17","14","8","6","31","77.50"
"828","Evan Bouchard","EDM","D","81","1306.1333333333","9","22","10","12","31","50.00"
"100","Josh Bailey","NYI","C, R","74","988.15","12","18","11","7","30","71.43"
"116","Gustav Nyquist","CBJ","C","82","1097.0666666667","9","21","14","7","30","50.85"
"240","Blake Coleman","CGY","C","81","1025.6","15","15","8","7","30","71.43"
"249","Boone Jenner","CBJ","C","59","876.75","14","16","8","8","30","69.77"
"305","Tom Wilson","WSH","R","78","1061.6333333333","14","16","7","9","30","52.63"
"469","Ryan Donato","SEA","C","74","862.36666666667","15","15","11","4","30","75.00"
"473","Brayden Point","T.B","C","66","953.8","15","15","10","5","30","52.63"
"684","Rem Pitlick","MIN, MTL","C","66","799.3","12","18","11","7","30","68.18"
"968","Anton Lundell","FLA","C","65","790.1","13","17","10","7","30","52.63"
"84","Mikael Backlund","CGY","C","82","1063.1833333333","10","19","14","5","29","60.42"
"87","Jakub Voracek","CBJ","R","79","1050.0666666667","2","27","24","3","29","63.04"
"157","Marcus Foligno","MIN","L","74","892.6","14","15","12","3","29","63.04"
"204","Ryan Johansen","NSH","C","79","940.11666666667","11","18","4","14","29","59.18"
"205","Tyler Seguin","DAL","C","81","1129.8833333333","17","12","10","2","29","78.38"
"208","Mikael Granlund","NSH","C","80","1104.5166666667","7","22","12","10","29","55.77"
"227","Travis Boyd","ARI","C","74","997.21666666667","14","15","9","6","29","54.72"
"252","Brandon Saad","STL","L","78","1024.5","13","16","9","7","29","63.04"
"278","Rickard Rakell","ANA, PIT","L, R","70","1027.6","14","15","8","7","29","53.70"
"309","Jacob Trouba","NYR","D","81","1463.0333333333","8","21","12","9","29","43.94"
"333","Jaccob Slavin","CAR","D","79","1386.35","3","26","10","16","29","39.19"
"366","MacKenzie Weegar","FLA","D","80","1488.0833333333","5","24","13","11","29","33.33"
"390","Shea Theodore","VGK","D","78","1484.05","7","22","12","10","29","43.28"
"440","Aaron Ekblad","FLA","D","61","1050.9166666667","10","19","5","14","29","43.28"
"460","Jared McCann","SEA","C, L","74","917.18333333333","17","12","7","5","29","78.38"
"483","Danton Heinen","PIT","L","76","865.33333333333","15","14","10","4","29","64.44"
"510","Noah Hanifin","CGY","D","81","1353.5","8","21","5","16","29","39.19"
"574","Evan Rodrigues","PIT","C","82","1056.95","9","20","12","8","29","65.91"
"723","Kailer Yamamoto","EDM","R","81","1174.55","14","15","9","6","29","53.70"
"746","Elias Pettersson","VAN","C","80","1089.0833333333","16","13","6","7","29","69.05"
"814","Pius Suter","DET","C","82","1066.8833333333","14","15","9","6","29","69.05"
"823","Joel Farabee","PHI","L","63","802.35","14","15","9","6","29","67.44"
"919","Matt Boldy","MIN","L","47","580.05","12","17","10","7","29","69.05"
"49","Kyle Okposo","BUF","R","74","956.11666666667","11","17","7","10","28","84.85"
"56","Jordan Staal","CAR","C","78","987.61666666667","13","15","7","8","28","60.87"
"69","James van Riemsdyk","PHI","L","82","1049.4833333333","15","13","7","6","28","68.29"
"114","Adam Henrique","ANA","C","58","824.01666666667","11","17","10","7","28","63.64"
"167","Anders Lee","NYI","C, L","76","1015.8","17","11","4","7","28","53.85"
"210","Bryan Rust","PIT","R","60","817.75","10","18","11","7","28","66.67"
"302","Mike Matheson","PIT","D","74","1264.5833333333","11","17","8","9","28","43.75"
"509","Frank Vatrano","FLA, NYR","C","71","853.65","15","13","10","3","28","77.78"
"548","Nicolas Roy","VGK","C","78","982.81666666667","13","15","12","3","28","57.14"
"693","Brandon Hagel","CHI, T.B","L","77","988.85","16","12","9","3","28","66.67"
"770","Josh Norris","OTT","C","66","900.25","16","12","6","6","28","62.22"
"981","Alexander Barabanov","S.J","L","70","1016.2333333333","6","22","13","9","28","60.87"
"10","Brent Burns","S.J","D","82","1567.15","6","21","10","11","27","39.71"
"60","Jonathan Toews","CHI","C","71","883.21666666667","7","20","13","7","27","65.85"
"80","David Perron","STL","L","67","909.31666666667","12","15","6","9","27","79.41"
"150","Reilly Smith","VGK","R","56","739.9","11","16","9","7","27","77.14"
"184","Charlie Coyle","BOS","C","82","1026.95","10","17","11","6","27","62.79"
"314","Colton Parayko","STL","D","80","1595.0333333333","4","23","7","16","27","33.75"
"384","Nicholas Paul","OTT, T.B","L","80","1065.85","13","14","4","10","27","72.97"
"411","Seth Jones","CHI","D","78","1525.3333333333","5","22","7","15","27","52.94"
"454","Travis Sanheim","PHI","D","80","1531.4333333333","6","21","11","10","27","34.62"
"468","Brandon Montour","FLA","D","81","1237.2833333333","9","18","6","12","27","39.13"
"486","Gustav Forsling","FLA","D","71","1241.2666666667","8","19","10","9","27","35.53"
"825","Quinn Hughes","VAN","D","76","1444.25","7","20","12","8","27","45.00"
"841","Rasmus Dahlin","BUF","D","80","1517.7333333333","9","18","10","8","27","45.76"
"937","Alex Newhook","COL","C","71","841.98333333333","10","17","9","8","27","79.41"
"965","Alexis Lafrenière","NYR","L","79","976.83333333333","18","9","4","5","27","69.23"
"6","Jeff Carter","PIT","C","76","996.46666666667","11","15","7","8","26","68.42"
"12","Corey Perry","T.B","R","82","931.6","8","18","14","4","26","70.27"
"106","John Carlson","WSH","D","78","1296.1833333333","5","21","14","7","26","44.07"
"130","Kyle Palmieri","NYI","C, R","69","901.7","13","13","7","6","26","59.09"
"153","Dmitry Orlov","WSH","D","76","1387.6333333333","9","17","12","5","26","40.63"
"215","Jesper Fast","CAR","R","82","1032.7","12","14","10","4","26","49.06"
"298","Tanner Pearson","VAN","L","68","898.8","11","15","7","8","26","63.41"
"326","Damon Severson","N.J","D","80","1393.7166666667","6","20","11","9","26","44.83"
"339","Josh Anderson","MTL","R","69","998.58333333333","14","12","6","6","26","66.67"
"346","Connor Brown","OTT","R","64","911.85","9","17","11","6","26","70.27"
"420","Alex Wennberg","SEA","C","80","1116.3333333333","8","18","11","7","26","65.00"
"498","Pierre Engvall","TOR","L","78","892.85","10","16","11","5","26","78.79"
"572","Anthony Cirelli","T.B","C","76","1036.4166666667","10","16","11","5","26","57.78"
"668","Mikhail Sergachev","T.B","D","78","1378.4333333333","5","21","11","10","26","41.27"
"793","Drake Batherson","OTT","R","46","667.26666666667","12","14","9","5","26","74.29"
"72","Logan Couture","S.J","C","77","1024","11","14","10","4","25","65.79"
"138","Evander Kane","EDM","L","43","681.16666666667","12","13","5","8","25","64.10"
"175","Christopher Tanev","CGY","D","82","1363.75","5","20","10","10","25","35.71"
"245","Jean-Gabriel Pageau","NYI","C","77","963.3","12","13","6","7","25","65.79"
"284","Barclay Goodrow","NYR","C","79","1040.8833333333","10","15","10","5","25","55.56"
"416","Bo Horvat","VAN","C","70","972.2","12","13","11","2","25","67.57"
"455","Alex Tuch","BUF","R","50","658.85","7","18","11","7","25","60.98"
"456","Tony DeAngelo","CAR","D","64","999.13333333333","8","17","10","7","25","38.46"
"462","Adrian Kempe","L.A","C, L","78","1027.1666666667","17","8","3","5","25","64.10"
"500","Jake Evans","MTL","C","72","915.55","11","14","9","5","25","64.10"
"511","Rasmus Andersson","CGY","D","82","1381.2166666667","2","23","13","10","25","33.33"
"564","Joel Eriksson Ek","MIN","C","77","931.55","11","14","8","6","25","55.56"
"594","Vladislav Gavrikov","CBJ","D","80","1466.45","4","21","10","11","25","36.23"
"622","Charlie McAvoy","BOS","D","78","1383.9","3","22","7","15","25","33.78"
"632","Jesse Puljujarvi","EDM","R","65","928.31666666667","9","16","9","7","25","49.02"
"675","Filip Hronek","DET","D","78","1346.05","2","23","12","11","25","47.17"
"756","Alex Formenton","OTT","L","79","966.78333333333","12","13","7","6","25","75.76"
"781","Alex Iafallo","L.A","L","79","1050.1666666667","11","14","6","8","25","64.10"
"837","Jesperi Kotkaniemi","CAR","C","66","706.98333333333","12","13","5","8","25","75.76"
"854","Noah Dobson","NYI","D","80","1355.8","8","17","12","5","25","43.86"
"905","Dylan Cozens","BUF","C","79","1026.85","11","14","5","9","25","65.79"
"969","Tim Stützle","OTT","L","79","1096.15","11","14","9","5","25","60.98"
"63","Jamie Benn","DAL","L","82","1043.4","9","15","7","8","24","64.86"
"91","Lars Eller","WSH","C","72","896.13333333333","11","13","11","2","24","60.00"
"117","Derek Grant","ANA","C","71","793.48333333333","11","13","8","5","24","82.76"
"256","William Karlsson","VGK","C","67","918.65","8","16","10","6","24","68.57"
"299","Scott Laughton","PHI","C","67","898.46666666667","8","16","7","9","24","70.59"
"387","Ryan Graves","N.J","D","75","1316.4","6","18","11","7","24","38.71"
"453","Sonny Milano","ANA","L","66","837.45","9","15","11","4","24","72.73"
"491","Oskar Lindblom","PHI","L","79","961.51666666667","11","13","7","6","24","64.86"
"515","Pavel Zacha","N.J","C","70","929.41666666667","8","16","9","7","24","60.00"
"529","Oliver Kylington","CGY","D","73","1193.6166666667","6","18","6","12","24","35.29"
"556","Lawson Crouse","ARI","L","65","843.58333333333","15","9","6","3","24","66.67"
"911","Cole Caufield","MTL","R","67","874","15","9","5","4","24","58.54"
"998","Cole Sillinger","CBJ","C","79","942.93333333333","14","10","6","4","24","70.59"
"8","Zach Parise","NYI","L","82","947.25","9","14","10","4","23","58.97"
"115","TJ Brodie","TOR","D","82","1475.05","4","19","10","9","23","32.86"
"151","Tomas Tatar","N.J","L","76","942.8","12","11","5","6","23","65.71"
"216","John Klingberg","DAL","D","74","1323.1166666667","3","20","12","8","23","42.59"
"277","Vladislav Namestnikov","DAL, DET","C","75","920.21666666667","12","11","5","6","23","63.89"
"307","Teuvo Teravainen","CAR","L","77","932.65","10","13","9","4","23","50.00"
"322","Adam Pelech","NYI","D","78","1377.4833333333","2","21","10","11","23","37.70"
"329","Teddy Blueger","PIT","C","65","795.78333333333","7","16","6","10","23","67.65"
"459","Kasperi Kapanen","PIT","R","79","978.58333333333","11","12","8","4","23","62.16"
"467","Nicolas Aube-Kubel","COL, PHI","R","74","716.83333333333","11","12","9","3","23","76.67"
"470","Christian Dvorak","MTL","L","56","699.71666666667","9","14","9","5","23","76.67"
"549","Anthony Beauvillier","NYI","L","75","1045.2","7","16","12","4","23","56.10"
"634","Dillon Dube","CGY","C","79","866.9","13","10","5","5","23","65.71"
"650","Dante Fabbro","NSH","D","66","1127.9333333333","2","21","11","10","23","41.07"
"936","Vasily Podkolzin","VAN","R","79","940.45","12","11","9","2","23","57.50"
"7","Dustin Brown","L.A","L, R","64","783.95","7","15","7","8","22","78.57"
"42","Anton Stralman","ARI","D","74","1301.45","7","15","7","8","22","36.67"
"85","Ryan McDonagh","T.B","D","71","1265.75","4","18","7","11","22","41.51"
"192","Kevin Hayes","PHI","C, R","48","643","6","16","8","8","22","73.33"
"217","Mark Stone","VGK","R","37","513.56666666667","5","17","12","5","22","73.33"
"344","Vinnie Hinostroza","BUF","C","62","807.51666666667","11","11","7","4","22","75.86"
"472","Warren Foegele","EDM","L","82","954.65","9","13","9","4","22","59.46"
"547","Zach Werenski","CBJ","D","68","1317.25","6","16","7","9","22","43.14"
"554","Thomas Chabot","OTT","D","59","1242.2333333333","6","16","6","10","22","36.67"
"555","Mathieu Joseph","OTT, T.B","R","69","797.63333333333","8","14","6","8","22","64.71"
"565","Denis Gurianov","DAL","R","73","868.93333333333","6","16","10","6","22","64.71"
"819","Eric Robinson","CBJ","L","67","758.08333333333","7","15","9","6","22","84.62"
"829","Isac Lundestrom","ANA","C","80","981.91666666667","11","11","7","4","22","70.97"
"912","Moritz Seider","DET","D","82","1395.4","2","20","9","11","22","34.38"
"925","Philip Tomasino","NSH","C","76","756.53333333333","8","14","12","2","22","66.67"
"9","Ryan Getzlaf","ANA","C","56","815.08333333333","1","20","11","9","21","75.00"
"71","Sam Gagner","DET","C","81","829.03333333333","8","13","10","3","21","63.64"
"86","Max Pacioretty","VGK","L","39","534.66666666667","14","7","2","5","21","72.41"
"122","Jared Spurgeon","MIN","D","65","956.98333333333","7","14","7","7","21","37.50"
"233","Sean Kuraly","CBJ","C","77","986.71666666667","10","11","2","9","21","47.73"
"262","Adam Larsson","SEA","D","82","1538.8833333333","7","14","9","5","21","38.89"
"286","Torey Krug","STL","D","64","1061.9166666667","4","17","9","8","21","31.34"
"304","Cody Ceci","EDM","D","78","1375.15","5","16","6","10","21","37.50"
"407","Brett Pesce","CAR","D","70","1206.9833333333","4","17","6","11","21","35.59"
"422","Nikita Zadorov","CGY","D","74","1162.9","3","18","8","10","21","46.67"
"436","Garnet Hathaway","WSH","R","76","889.35","11","10","3","7","21","55.26"
"518","Vince Dunn","SEA","D","73","1266.7833333333","5","16","6","10","21","41.18"
"532","Keegan Kolesar","VGK","R","77","879.1","5","16","11","5","21","63.64"
"578","Derek Ryan","EDM","C","75","710.55","10","11","6","5","21","63.64"
"733","Michael Rasmussen","DET","C","80","940.66666666667","13","8","5","3","21","63.64"
"740","Jesper Boqvist","N.J","C","56","681.18333333333","9","12","6","6","21","77.78"
"759","Miro Heiskanen","DAL","D","70","1345.9666666667","1","20","9","11","21","42.00"
"788","Eetu Luostarinen","FLA","C","78","868.75","6","15","8","7","21","65.63"
"984","Artem Zub","OTT","D","81","1462.1166666667","6","15","6","9","21","41.18"
"25","Alex Goligoski","MIN","D","72","1113.9","2","18","7","11","20","24.69"
"54","Jeff Petry","MTL","D","68","1155.1166666667","6","14","6","8","20","38.46"
"68","Pat Maroon","T.B","L","81","889.35","8","12","6","6","20","54.05"
"73","P.K. Subban","N.J","D","77","1252.6166666667","5","15","7","8","20","34.48"
"102","Erik Karlsson","S.J","D","50","890.66666666667","7","13","6","7","20","50.00"
"105","Tyler Ennis","OTT","C, R","57","608.65","7","13","10","3","20","86.96"
"145","Dmitry Kulikov","MIN","D","80","1239.7666666667","5","15","9","6","20","31.25"
"156","Mattias Ekholm","NSH","D","76","1311.6166666667","5","15","6","9","20","30.77"
"177","Calle Jarnkrok","CGY, SEA","C","66","797.3","8","12","3","9","20","62.50"
"180","Tyler Toffoli","CGY, MTL","C, R","74","887.91666666667","6","14","9","5","20","68.97"
"259","Ryan Nugent-Hopkins","EDM","C","63","820.7","6","14","9","5","20","52.63"
"330","Jake McCabe","CHI","D","75","1278.6","3","17","7","10","20","41.67"
"331","Brock McGinn","PIT","L","64","809.35","10","10","7","3","20","76.92"
"362","Dominik Kubalik","CHI","L","78","972.35","10","10","1","9","20","64.52"
"378","Mattias Janmark","VGK","C","67","828.01666666667","6","14","6","8","20","62.50"
"404","William Carrier","VGK","L","63","707.25","9","11","5","6","20","57.14"
"414","Darnell Nurse","EDM","D","71","1397.55","6","14","7","7","20","33.90"
"458","Robby Fabbri","DET","C","56","761.23333333333","10","10","7","3","20","68.97"
"520","Jordan Greenway","MIN","L","62","753.41666666667","6","14","5","9","20","46.51"
"538","Brock Boeser","VAN","R","71","1025.3","9","11","4","7","20","57.14"
"570","Yakov Trenin","NSH","C","80","1000.6166666667","13","7","3","4","20","60.61"
"615","Luke Kunin","NSH","C","82","952.15","13","7","5","2","20","58.82"
"663","Samuel Girard","COL","D","67","1227.4833333333","4","16","7","9","20","32.79"
"763","Timothy Liljegren","TOR","D","61","892.73333333333","4","16","5","11","20","35.09"
"778","Filip Chytil","NYR","C","67","788.55","8","12","7","5","20","68.97"
"11","Brian Boyle","PIT","C","66","572.58333333333","10","9","4","5","19","82.61"
"43","Patric Hornqvist","FLA","R","65","667.3","8","11","4","7","19","63.33"
"48","Erik Johnson","COL","D","77","1059.0333333333","6","13","6","7","19","33.33"
"67","Kevin Shattenkirk","ANA","D","82","1356.4666666667","6","13","9","4","19","36.54"
"97","Alex Pietrangelo","VGK","D","80","1483.8","7","12","6","6","19","28.79"
"111","Derek Stepan","CAR","C","58","561.28333333333","9","10","6","4","19","76.00"
"168","Nick Jensen","WSH","D","76","1247.7166666667","5","14","7","7","19","29.23"
"169","Nic Dowd","WSH","C","64","757.11666666667","9","10","8","2","19","65.52"
"178","Justin Holl","TOR","D","69","1166.3666666667","2","17","5","12","19","33.33"
"186","Jon Merrill","MIN","D","69","1020.4","4","15","6","9","19","33.33"
"193","Cam Fowler","ANA","D","76","1379.8","2","17","6","11","19","31.15"
"267","Dougie Hamilton","N.J","D","62","1049.3333333333","6","13","5","8","19","32.76"
"291","Alex Galchenyuk","ARI","C","60","725.76666666667","5","14","7","7","19","63.33"
"315","Oskar Sundqvist","DET, STL","C","59","667.3","7","12","9","3","19","55.88"
"328","Colton Sissons","NSH","C","79","970.8","5","14","5","9","19","59.38"
"424","Anthony Mantha","WSH","R","37","468.7","7","12","10","2","19","67.86"
"448","Nick Ritchie","ARI, TOR","L","57","634.58333333333","11","8","3","5","19","76.00"
"530","Evgeny Svechnikov","WPG","L","72","763.96666666667","7","12","5","7","19","73.08"
"567","Ivan Provorov","PHI","D","79","1478.2833333333","7","12","3","9","19","33.33"
"569","John Marino","PIT","D","81","1338.3666666667","1","18","7","11","19","39.58"
"590","Rudolfs Balcers","S.J","L","61","803.3","10","9","5","4","19","61.29"
"782","David Kampf","TOR","C","82","1007","8","11","6","5","19","50.00"
"890","Logan O'Connor","COL","R","81","925.2","7","12","8","4","19","57.58"
"896","Blake Lizotte","L.A","C","70","745.85","8","11","7","4","19","59.38"
"938","Ilya Mikheyev","TOR","R","53","645.91666666667","11","8","6","2","19","59.38"
"5","Ryan Suter","DAL","D","82","1546.0166666667","3","15","4","11","18","30.51"
"18","Mark Giordano","SEA, TOR","D","75","1176.4666666667","3","15","8","7","18","35.29"
"20","Evgeni Malkin","PIT","C","41","555.86666666667","10","8","3","5","18","78.26"
"65","Ian Cole","CAR","D","75","1071.7833333333","2","16","6","10","18","40.00"
"127","Mike Hoffman","MTL","C","67","894.63333333333","10","8","5","3","18","58.06"
"129","Marcus Johansson","SEA, WSH","L","69","881.86666666667","6","12","8","4","18","54.55"
"140","Oliver Ekman-Larsson","VAN","D","79","1387.7166666667","2","16","9","7","18","32.73"
"165","Ben Chiarot","FLA, MTL","D","74","1334.05","6","12","8","4","18","36.00"
"211","Joonas Donskoi","SEA","R","75","845.6","2","16","4","12","18","64.29"
"313","Matt Grzelcyk","BOS","D","73","1176.75","3","15","6","9","18","28.57"
"336","Brett Kulak","EDM, MTL","D","74","1185.7166666667","5","13","5","8","18","35.29"
"357","Nate Schmidt","WPG","D","77","1306.9166666667","2","16","9","7","18","38.30"
"394","J.T. Compher","COL","L","70","843.21666666667","11","7","4","3","18","51.43"
"419","Josh Morrissey","WPG","D","79","1478.8166666667","5","13","9","4","18","30.00"
"465","Marcus Pettersson","PIT","D","72","1064.6666666667","2","16","11","5","18","42.86"
"476","Michael Amadio","TOR, VGK","C","56","663.41666666667","11","7","4","3","18","64.29"
"499","Ondrej Kase","TOR","R","50","571.61666666667","9","9","4","5","18","85.71"
"584","Alexandre Carrier","NSH","D","77","1235.3666666667","1","17","7","10","18","32.73"
"625","Rasmus Asplund","BUF","C","80","974.43333333333","2","16","12","4","18","52.94"
"644","Trent Frederic","BOS","C","60","651.93333333333","8","10","9","1","18","69.23"
"661","Noah Gregor","S.J","C","63","810.61666666667","8","10","5","5","18","72.00"
"665","Jake Bean","CBJ","D","67","1178.7333333333","5","13","4","9","18","34.62"
"731","Morgan Geekie","SEA","C","73","791.25","7","11","6","5","18","69.23"
"783","Neal Pionk","WPG","D","77","1313.7333333333","1","17","9","8","18","31.03"
"786","Jan Rutta","T.B","D","76","1121.5166666667","3","15","5","10","18","28.57"
"817","Zach Whitecloud","VGK","D","59","983.25","7","11","8","3","18","32.73"
"902","Kirby Dach","CHI","C","70","986.21666666667","7","11","7","4","18","48.65"
"4","Duncan Keith","EDM","D","64","1065.1333333333","1","16","9","7","17","32.69"
"13","Loui Eriksson","ARI","L","73","819.66666666667","2","15","8","7","17","62.96"
"52","Milan Lucic","CGY","L","82","898.18333333333","8","9","5","4","17","65.38"
"64","Nick Bonino","S.J","C","80","1004.6666666667","11","6","4","2","17","58.62"
"66","Justin Braun","NYR, PHI","D","69","1162.45","6","11","4","7","17","42.50"
"108","Justin Schultz","WSH","D","74","1102.4833333333","2","15","9","6","17","39.53"
"152","Tyson Barrie","EDM","D","73","1100.1833333333","4","13","8","5","17","31.48"
"171","Brenden Dillon","WPG","D","79","1301.5833333333","2","15","5","10","17","30.36"
"181","Johan Larsson","ARI, WSH","L","43","559.88333333333","4","13","4","9","17","65.38"
"201","Erik Gudbranson","CGY","D","78","1161.6833333333","6","11","5","6","17","34.00"
"213","Sam Carrick","ANA","C","64","656.61666666667","9","8","2","6","17","85.00"
"238","Nick Cousins","NSH","C","68","717.43333333333","5","12","6","6","17","70.83"
"251","Victor Rask","MIN, SEA","C","47","521.3","7","10","5","5","17","68.00"
"255","Matt Nieto","S.J","L","70","853.41666666667","6","11","8","3","17","68.00"
"293","Hampus Lindholm","ANA, BOS","D","71","1287.3166666667","4","13","6","7","17","30.36"
"294","Matt Dumba","MIN","D","57","1014.75","5","12","7","5","17","41.46"
"438","Pierre-Edouard Bellemare","T.B","L","80","866.56666666667","8","9","4","5","17","47.22"
"551","Daniel Sprong","SEA, WSH","R","63","726.81666666667","12","5","3","2","17","56.67"
"606","Ryan Lomberg","FLA","L","55","554.18333333333","9","8","3","5","17","65.38"
"637","Sam Steel","ANA","C","68","763.01666666667","6","11","5","6","17","68.00"
"638","Brett Howden","VGK","C","47","468.18333333333","8","9","5","4","17","70.83"
"649","Tyson Jost","COL, MIN","C","80","831.51666666667","6","11","7","4","17","60.71"
"660","Taylor Raddysh","CHI, T.B","R","74","758.63333333333","7","10","8","2","17","51.52"
"671","Michael McLeod","N.J","C","77","831.9","5","12","6","6","17","58.62"
"748","Owen Tippett","FLA, PHI","R","63","724.03333333333","8","9","6","3","17","53.13"
"833","K'Andre Miller","NYR","D","82","1467.4","4","13","7","6","17","27.87"
"848","Barrett Hayton","ARI","C","60","753.35","7","10","6","4","17","56.67"
"921","Arthur Kaliyev","L.A","R","80","838.33333333333","8","9","7","2","17","50.00"
"926","Connor McMichael","WSH","C","68","696.5","8","9","7","2","17","65.38"
"57","Derick Brassard","EDM, PHI","C","46","497","7","9","5","4","16","69.57"
"95","Drew Doughty","L.A","D","39","750.95","2","14","7","7","16","45.71"
"154","Brian Dumoulin","PIT","D","76","1405.6833333333","3","13","4","9","16","23.88"
"268","Jonas Brodin","MIN","D","73","1278.8666666667","3","13","4","9","16","29.09"
"393","Adam Erne","DET","L","79","952.23333333333","5","11","7","4","16","59.26"
"406","Zach Sanford","OTT, WPG","L","80","979.53333333333","7","9","4","5","16","55.17"
"410","Jonathan Drouin","MTL","L","34","466.1","6","10","7","3","16","80.00"
"595","Mason Appleton","SEA, WPG","C","68","903.28333333333","6","10","6","4","16","50.00"
"744","Eeli Tolvanen","NSH","R","75","832.46666666667","10","6","4","2","16","53.33"
"794","Jacob Peterson","DAL","C","65","654","12","4","3","1","16","69.57"
"821","Oliver Wahlstrom","NYI","R","73","749.33333333333","8","8","6","2","16","55.17"
"827","Ryan McLeod","EDM","C","71","745","7","9","6","3","16","64.00"
"856","Adam Boqvist","CBJ","D","52","748.01666666667","8","8","3","5","16","40.00"
"860","Ty Smith","N.J","D","66","1019.5333333333","5","11","3","8","16","40.00"
"27","Alexander Edler","L.A","D","41","642.56666666667","3","12","7","5","15","48.39"
"92","Wayne Simmonds","TOR","R","72","647.95","5","10","4","6","15","65.22"
"101","Tyler Myers","VAN","D","82","1501.3333333333","1","14","8","6","15","23.81"
"134","Jakob Silfverberg","ANA","R","53","651.63333333333","4","11","6","5","15","65.22"
"220","Colin Blackwell","SEA, TOR","C","58","601.93333333333","8","7","3","4","15","75.00"
"224","Josh Manson","ANA, COL","D","67","1093.7833333333","6","9","4","5","15","39.47"
"285","Brad Hunt","VAN","D","50","700.28333333333","3","12","6","6","15","50.00"
"316","Esa Lindell","DAL","D","76","1358.6833333333","3","12","9","3","15","30.00"
"325","Jordan Martinook","CAR","L","59","623.41666666667","6","9","6","3","15","62.50"
"371","Carson Soucy","SEA","D","64","947.11666666667","9","6","3","3","15","38.46"
"423","Curtis Lazar","BOS","C","70","708.9","8","7","3","4","15","68.18"
"432","Trevor van Riemsdyk","WSH","D","72","1033.0333333333","1","14","5","9","15","35.71"
"439","Tomas Nosek","BOS","L","75","829.96666666667","3","12","7","5","15","57.69"
"471","Juho Lammikko","VAN","L","75","794.56666666667","7","8","6","2","15","57.69"
"517","Jack Eichel","VGK","C","34","515.13333333333","10","5","4","1","15","65.22"
"598","Matt Roy","L.A","D","67","1145.7833333333","2","13","10","3","15","31.25"
"633","Jakob Chychrun","ARI","D","47","854.88333333333","5","10","5","5","15","51.72"
"640","Kieffer Bellows","NYI","L","45","509.56666666667","6","9","5","4","15","68.18"
"682","Janne Kuokkanen","N.J","C, L","57","685.31666666667","4","11","4","7","15","55.56"
"687","Brandon Duhaime","MIN","R","80","748.08333333333","5","10","5","5","15","57.69"
"824","Philipp Kurashev","CHI","C","67","751.28333333333","3","12","8","4","15","71.43"
"831","Joe Veleno","DET","C","66","803.06666666667","8","7","4","3","15","65.22"
"909","Nils Hoglander","VAN","L","60","712.91666666667","9","6","2","4","15","62.50"
"917","Kaapo Kakko","NYR","R","43","569.91666666667","6","9","4","5","15","65.22"
"23","Alexander Radulov","DAL","R","71","818.86666666667","3","11","8","3","14","56.00"
"36","Marc-Edouard Vlasic","S.J","D","75","1055.8833333333","3","11","5","6","14","51.85"
"59","Nicklas Backstrom","WSH","C","47","598.45","4","10","7","3","14","56.00"
"93","Nick Holden","OTT","D","76","1222.7333333333","5","9","6","3","14","32.56"
"99","Luke Schenn","VAN","D","66","991.3","2","12","7","5","14","33.33"
"144","Zack Kassian","EDM","R","58","656.58333333333","3","11","8","3","14","46.67"
"146","Nick Leddy","DET, STL","D","75","1373.9666666667","3","11","3","8","14","28.00"
"149","Brayden McNabb","VGK","D","69","1139.1166666667","1","13","4","9","14","28.57"
"159","Chris Wideman","MTL","D","64","759.23333333333","4","10","5","5","14","53.85"
"160","Casey Cizikas","NYI","C","74","846.26666666667","9","5","3","2","14","73.68"
"161","David Savard","MTL","D","62","1078.3833333333","3","11","4","7","14","35.00"
"179","Jason Zucker","PIT","L","41","534.61666666667","5","9","5","4","14","58.33"
"196","Jaden Schwartz","SEA","C","37","549.58333333333","4","10","6","4","14","60.87"
"214","Brendan Gallagher","MTL","R","56","684.35","1","13","9","4","14","43.75"
"270","Jamie Oleksiak","SEA","D","72","1212.5","0","14","8","6","14","27.45"
"312","Radek Faksa","DAL","C","77","1009.6166666667","2","12","6","6","14","70.00"
"506","Dryden Hunt","NYR","L","76","896.8","5","9","5","4","14","58.33"
"626","Carl Grundstrom","L.A","R","54","565.23333333333","8","6","3","3","14","73.68"
"670","Nathan Bastian","N.J, SEA","R","72","692.63333333333","9","5","4","1","14","58.33"
"724","Nicolas Hague","VGK","D","52","848.33333333333","4","10","4","6","14","31.82"
"755","Morgan Frost","PHI","C","55","634.2","4","10","7","3","14","70.00"
"757","Max Comtois","ANA","L","52","626.11666666667","6","8","3","5","14","56.00"
"771","Ryan Poehling","MTL","C","57","586.33333333333","6","8","5","3","14","82.35"
"777","Alexandre Texier","CBJ","C","36","440.2","7","7","6","1","14","70.00"
"822","Martin Fehervary","WSH","D","79","1360.5833333333","6","8","5","3","14","22.95"
"834","Filip Zadina","DET","R","74","878.23333333333","6","8","4","4","14","42.42"
"895","Nico Sturm","COL, MIN","C","74","739.48333333333","5","9","4","5","14","53.85"
"974","Jamie Drysdale","ANA","D","81","1361.6166666667","3","11","7","4","14","26.42"
"3","Jason Spezza","TOR","C","71","633.31666666667","7","6","4","2","13","61.90"
"32","Marc Staal","DET","D","71","1045.9","2","11","6","5","13","23.21"
"33","T.J. Oshie","WSH","R","44","561.65","6","7","3","4","13","65.00"
"173","Radko Gudas","FLA","D","77","1189.7","2","11","6","5","13","21.67"
"191","Derek Forbort","BOS","D","76","1099.6833333333","4","9","2","7","13","31.71"
"197","Riley Sheahan","SEA","C","69","668.33333333333","4","9","5","4","13","50.00"
"248","Scott Mayfield","NYI","D","61","1020.65","3","10","6","4","13","39.39"
"303","Zemgus Girgensons","BUF","L","56","668.8","7","6","5","1","13","68.42"
"324","Chris Tierney","OTT","C","70","745.15","3","10","1","9","13","59.09"
"347","Ben Hutton","VGK","D","58","839.76666666667","3","10","6","4","13","35.14"
"359","Chad Ruhwedel","PIT","D","78","1047.1","4","9","3","6","13","27.66"
"360","Michael Raffl","DAL","L","76","930.58333333333","6","7","6","1","13","81.25"
"367","Tyler Motte","NYR, VAN","C","58","681.21666666667","5","8","5","3","13","48.15"
"415","Rasmus Ristolainen","PHI","D","66","1200.8166666667","2","11","5","6","13","24.07"
"421","Ryan Pulock","NYI","D","56","960","2","11","5","6","13","28.89"
"451","Jakub Vrana","DET","L","26","315.85","8","5","5","0","13","92.86"
"463","Brendan Lemieux","L.A","L","50","524.31666666667","8","5","3","2","13","56.52"
"523","Erik Cernak","T.B","D","55","856.38333333333","1","12","7","5","13","34.21"
"526","Jansen Harkins","WPG","C","77","708.5","7","6","3","3","13","76.47"
"543","Ethan Bear","CAR","D","58","823.76666666667","5","8","5","3","13","35.14"
"596","Steven Lorentz","CAR","C","67","692.93333333333","8","5","2","3","13","56.52"
"621","Ryan Lindgren","NYR","D","78","1333.2833333333","2","11","6","5","13","24.53"
"652","Jonathan Dahlen","S.J","C","61","705.25","8","5","4","1","13","56.52"
"716","Justin Danforth","CBJ","R","45","515.96666666667","10","3","2","1","13","61.90"
"717","Zach Aston-Reese","ANA, PIT","C, L","69","779.91666666667","3","10","6","4","13","50.00"
"758","Henri Jokiharju","BUF","D","60","1084.3166666667","2","11","6","5","13","30.23"
"903","Bowen Byram","COL","D","30","506.53333333333","3","10","5","5","13","46.43"
"986","Yegor Chinakhov","CBJ","R","62","677.68333333333","6","7","5","2","13","56.52"
"1","Zdeno Chara","NYI","D","72","1187.8","2","10","6","4","12","24.49"
"41","Ryan Reaves","NYR","R","69","723.66666666667","4","8","3","5","12","75.00"
"47","Nick Foligno","BOS","L","64","680.35","2","10","6","4","12","85.71"
"88","Jake Muzzin","TOR","D","47","802.78333333333","3","9","3","6","12","34.29"
"90","Carl Hagelin","WSH","L","53","638.5","2","10","4","6","12","57.14"
"133","Alex Chiasson","VAN","R","67","639.23333333333","7","5","4","1","12","44.44"
"206","Mark Pysyk","BUF","D","68","1047.6833333333","3","9","3","6","12","34.29"
"246","Mike Reilly","BOS","D","70","1160.0833333333","3","9","5","4","12","26.09"
"288","Luke Glendening","DAL","C","82","923.63333333333","9","3","1","2","12","63.16"
"323","Jimmy Vesey","N.J","L","68","802.95","5","7","3","4","12","60.00"
"428","Nathan Walker","STL","L","30","338.2","8","4","3","1","12","85.71"
"482","Sam Lafferty","CHI, PIT","C, R","56","628.21666666667","5","7","6","1","12","66.67"
"513","Jonas Siegenthaler","N.J","D","70","1228.9333333333","1","11","4","7","12","22.64"
"537","Brandon Carlo","BOS","D","79","1273.7333333333","5","7","4","3","12","26.09"
"588","Dominik Simon","ANA, PIT","C","72","703.91666666667","3","9","6","3","12","46.15"
"592","Adam Gaudette","CHI, OTT","C","58","582.05","3","9","5","4","12","75.00"
"648","Andrew Peeke","CBJ","D","82","1447.5666666667","0","12","4","8","12","23.08"
"654","Logan Stanley","WPG","D","58","755.26666666667","1","11","5","6","12","46.15"
"697","Maxim Mamin","FLA","C","40","466.38333333333","5","7","4","3","12","48.00"
"727","Mario Ferraro","S.J","D","63","1188.15","2","10","3","7","12","27.27"
"787","Gustav Lindstrom","DET","D","63","917.68333333333","1","11","3","8","12","37.50"
"813","Parker Kelly","OTT","C, L","41","390.63333333333","7","5","0","5","12","85.71"
"857","Rasmus Sandin","TOR","D","51","765.75","4","8","4","4","12","31.58"
"867","Ilya Lyubushkin","ARI, TOR","D","77","1164.4666666667","1","11","5","6","12","27.27"
"34","Andrew Cogliano","COL, S.J","C","74","779.26666666667","2","9","4","5","11","50.00"
"40","Darren Helm","COL","C","68","575.78333333333","6","5","2","3","11","68.75"
"50","Trevor Lewis","CGY","C","80","863.45","2","9","3","6","11","40.74"
"53","Cal Clutterbuck","NYI","R","59","683.58333333333","3","8","0","8","11","78.57"
"162","Nicolas Deslauriers","ANA, MIN","L","81","809.55","6","5","3","2","11","61.11"
"190","Nick Bjugstad","MIN","C","57","563.56666666667","6","5","2","3","11","57.89"
"195","Austin Watson","OTT","L","67","695.45","7","4","4","0","11","61.11"
"237","Adam Lowry","WPG","C, L","79","941.06666666667","8","3","2","1","11","57.89"
"334","Andreas Athanasiou","L.A","C","28","357.31666666667","7","4","2","2","11","64.71"
"338","Erik Gustafsson","CHI","D","59","789.76666666667","2","9","6","3","11","32.35"
"389","Michael McCarron","NSH","R","51","463.63333333333","6","5","3","2","11","55.00"
"395","Laurent Dauphin","MTL","C","38","445.71666666667","3","8","4","4","11","61.11"
"490","Dysin Mayo","ARI","D","67","1168.3","4","7","2","5","11","28.95"
"502","Matthew Highmore","VAN","C","46","518.48333333333","4","7","3","4","11","61.11"
"586","Niko Mikkola","STL","D","54","811.13333333333","2","9","6","3","11","29.73"
"694","Michael Pezzetta","MTL","L","51","387.38333333333","5","6","5","1","11","68.75"
"753","MacKenzie Entwistle","CHI","R","55","516.6","4","7","4","3","11","73.33"
"792","Emil Bemstrom","CBJ","C","41","383.41666666667","6","5","2","3","11","68.75"
"901","Peyton Krebs","BUF, VGK","C","57","690.86666666667","7","4","4","0","11","52.38"
"993","Janis Moser","ARI","D","43","656.46666666667","3","8","5","3","11","33.33"
"44","Andy Greene","NYI","D","69","1044.6666666667","2","8","5","3","10","27.03"
"103","Michael Del Zotto","OTT","D","26","411.61666666667","2","8","3","5","10","43.48"
"110","Travis Hamonic","OTT, VAN","D","43","710.25","4","6","2","4","10","34.48"
"274","Connor Murphy","CHI","D","57","1046.5333333333","4","6","2","4","10","27.78"
"281","Colin Miller","BUF","D","38","605.31666666667","2","8","4","4","10","35.71"
"320","Devin Shore","EDM","C","49","404.8","4","6","4","2","10","66.67"
"342","Matthew Benning","NSH","D","65","885.21666666667","0","10","6","4","10","38.46"
"356","Danny DeKeyser","DET","D","59","917.15","0","10","6","4","10","35.71"
"370","Connor Clifton","BOS","D","60","867.36666666667","2","8","3","5","10","29.41"
"413","Sean Monahan","CGY","C","65","743.61666666667","3","7","5","2","10","47.62"
"433","Ryan Carpenter","CGY, CHI","C","67","679","2","8","3","5","10","62.50"
"544","Caleb Jones","CHI","D","51","783.85","4","6","3","3","10","34.48"
"576","Dean Kukan","CBJ","D","41","605.96666666667","3","7","1","6","10","31.25"
"645","Logan Brown","STL","C","39","377","4","6","4","2","10","83.33"
"659","Riley Stillman","CHI","D","52","705.56666666667","2","8","6","2","10","37.04"
"715","Gerry Mayhew","ANA, PHI","C","40","478.18333333333","9","1","0","1","10","62.50"
"737","Casey Mittelstadt","BUF","C","40","496.98333333333","4","6","3","3","10","55.56"
"743","Adam Ruzicka","CGY","C","28","277.33333333333","5","5","4","1","10","71.43"
"796","Sebastian Aho","NYI","D","36","545.38333333333","2","8","1","7","10","43.48"
"874","Alexander Romanov","MTL","D","79","1355.25","3","7","2","5","10","18.18"
"959","Braden Schneider","NYR","D","43","630.73333333333","2","8","3","5","10","43.48"
"112","Marco Scandella","STL","D","70","1071.3833333333","2","7","3","4","9","17.65"
"128","Tyler Bozak","STL","C","50","513.15","2","7","3","4","9","75.00"
"212","Jani Hakanpaa","DAL","D","80","1077.5333333333","2","7","3","4","9","23.08"
"228","Dylan DeMelo","WPG","D","76","1167.6833333333","0","9","4","5","9","21.43"
"332","Dominic Toninato","WPG","C","77","522.18333333333","6","3","3","0","9","64.29"
"361","Anton Blidh","BOS","L","32","311.36666666667","2","7","4","3","9","90.00"
"391","Jason Dickinson","VAN","C","62","698.46666666667","4","5","2","3","9","50.00"
"435","Patrick Brown","PHI","C","44","460.16666666667","4","5","4","1","9","64.29"
"501","Jacob Middleton","MIN, S.J","D","66","1072.1333333333","3","6","3","3","9","19.57"
"568","Gabriel Carlsson","CBJ","D","38","431.61666666667","2","7","3","4","9","39.13"
"610","Kevin Rooney","NYR","C","61","687.78333333333","5","4","2","2","9","60.00"
"688","Lucas Carlsson","FLA","D","40","497.75","3","6","3","3","9","36.00"
"706","Dylan Coghlan","VGK","D","59","746.81666666667","1","8","4","4","9","37.50"
"714","Zack MacEwen","PHI","C","75","706.91666666667","3","6","3","3","9","45.00"
"728","Cal Foote","T.B","D","56","714.33333333333","2","7","4","3","9","25.71"
"745","Klim Kostin","STL","C","40","357.43333333333","4","5","2","3","9","69.23"
"810","Sean Durzi","L.A","D","64","961.31666666667","1","8","4","4","9","24.32"
"830","Mattias Samuelsson","BUF","D","42","714.48333333333","0","9","5","4","9","28.13"
"844","Rasmus Kupari","L.A","C","57","603.68333333333","3","6","4","2","9","56.25"
"864","Karson Kuhlman","BOS, SEA","C","44","470.8","2","7","2","5","9","75.00"
"879","Jasper Weatherby","S.J","C","50","490.98333333333","4","5","3","2","9","69.23"
"971","Quinton Byfield","L.A","C","40","457.3","5","4","4","0","9","69.23"
"15","Brad Richardson","CGY, VAN","R","44","411.8","4","4","2","2","8","72.73"
"21","Andrew Ladd","ARI","L","51","587.55","4","4","1","3","8","50.00"
"38","Kris Russell","EDM","D","31","408.4","1","7","3","4","8","40.00"
"39","Keith Yandle","PHI","D","77","875.81666666667","0","8","3","5","8","33.33"
"89","Alec Martinez","VGK","D","26","450.81666666667","3","5","1","4","8","38.10"
"98","Zach Bogosian","T.B","D","48","705.06666666667","3","5","2","3","8","36.36"
"125","Antoine Roussel","ARI","L","53","538.6","4","4","4","0","8","66.67"
"163","Cody Eakin","BUF","C","69","825.5","3","5","0","5","8","40.00"
"222","Ryan Dzingel","ARI, S.J","C","32","387.1","5","3","3","0","8","61.54"
"272","Joel Armia","MTL","R","60","675.3","4","4","3","1","8","42.11"
"301","Olli Maatta","L.A","D","66","1054.0833333333","1","7","2","5","8","20.51"
"349","Jaycob Megna","S.J","D","44","734.25","2","6","3","3","8","32.00"
"488","Dakota Joshua","STL","C","30","249.8","3","5","3","2","8","53.33"
"493","Anders Bjork","BUF","L","58","653.81666666667","5","3","3","0","8","50.00"
"531","Christian Fischer","ARI","R","53","576.41666666667","4","4","3","1","8","72.73"
"611","Brandon Tanev","SEA","L","30","377.48333333333","4","4","2","2","8","72.73"
"718","Gavin Bayreuther","CBJ","D","43","535.08333333333","0","8","3","5","8","29.63"
"730","Kole Lind","SEA","R","23","267.43333333333","2","6","1","5","8","72.73"
"789","Fabian Zetterlund","N.J","L","14","162.41666666667","3","5","3","2","8","61.54"
"795","Noah Cates","PHI","L","16","191.16666666667","4","4","3","1","8","72.73"
"932","Tobias Bjornfot","L.A","D","70","1048.65","0","8","3","5","8","23.53"
"942","Aliaksei Protas","WSH","C","33","352.3","3","5","4","1","8","50.00"
"2","Joe Thornton","FLA","C","34","330.53333333333","2","5","3","2","7","58.33"
"30","Jack Johnson","COL","D","74","1050.6833333333","1","6","2","4","7","18.92"
"61","Mathieu Perreault","MTL","C","25","242.78333333333","3","4","2","2","7","50.00"
"78","Brendan Smith","CAR","D","45","571.86666666667","3","4","2","2","7","30.43"
"124","Jordie Benn","MIN","D","39","540.65","0","7","4","3","7","24.14"
"229","Gregory Hofmann","CBJ","C","24","275.76666666667","2","5","2","3","7","50.00"
"266","Sean Couturier","PHI","C","29","417.43333333333","3","4","2","2","7","46.67"
"295","Brendan Gaunce","CBJ","C","30","239.06666666667","5","2","1","1","7","63.64"
"426","Ross Johnston","NYI","L","32","325.15","2","5","2","3","7","77.78"
"434","Jordan Oesterle","DET","D","45","744.86666666667","1","6","4","2","7","25.00"
"474","Jake Walman","DET, STL","D","51","646.73333333333","1","6","2","4","7","36.84"
"571","Austin Czarnik","NYI, SEA","C","17","167.5","2","5","3","2","7","63.64"
"577","Noel Acciari","FLA","C","20","209.75","3","4","2","2","7","70.00"
"581","Will Borgen","SEA","D","36","505.28333333333","2","5","4","1","7","50.00"
"630","Cam Dineen","ARI","D","34","470.55","0","7","3","4","7","50.00"
"651","Josh Mahura","ANA","D","38","517.48333333333","3","4","2","2","7","53.85"
"655","Givani Smith","DET","R","46","386.53333333333","4","3","3","0","7","63.64"
"657","Boris Katchouk","CHI, T.B","L","59","543.85","3","4","2","2","7","53.85"
"679","Nikita Zaitsev","OTT","D","62","973","1","6","3","3","7","19.44"
"736","Mikey Anderson","L.A","D","57","1006.7166666667","2","5","4","1","7","16.67"
"765","Sasha Chmelevski","S.J","C","19","234.68333333333","0","7","3","4","7","87.50"
"940","Joel Kiviranta","DAL","L","56","524.16666666667","1","6","2","4","7","50.00"
"120","Matt Martin","NYI","L","71","795.15","2","4","3","1","6","27.27"
"143","Calvin de Haan","CHI","D","69","1150.6833333333","3","3","2","1","6","17.14"
"354","Andrej Sustr","ANA, T.B","D","38","512.83333333333","1","5","2","3","6","42.86"
"355","Buddy Robinson","ANA","R","32","275.36666666667","1","5","3","2","6","75.00"
"368","Will Butcher","BUF","D","37","564.28333333333","2","4","2","2","6","33.33"
"373","Josh Brown","BOS, OTT","D","52","634.46666666667","0","6","4","2","6","28.57"
"397","Robert Hagg","BUF, FLA","D","64","884.63333333333","0","6","3","3","6","19.35"
"485","Max Willman","PHI","C","41","461.63333333333","4","2","0","2","6","50.00"
"519","Travis Dermott","TOR, VAN","D","60","865.83333333333","1","5","2","3","6","15.79"
"552","Nicolas Meloche","S.J","D","50","765.7","2","4","1","3","6","23.08"
"553","Jeremy Lauzon","NSH, SEA","D","66","1007.8666666667","2","4","3","1","6","18.18"
"558","Mitchell Stephens","DET","C","27","256.31666666667","0","6","3","3","6","85.71"
"623","Julien Gauthier","NYR","R","49","477.15","2","4","2","2","6","46.15"
"636","Kale Clague","L.A, MTL","D","36","503.25","2","4","2","2","6","50.00"
"653","Victor Mete","OTT","D","37","451.11666666667","0","6","6","0","6","60.00"
"666","Henrik Borgstrom","CHI","C","52","501.68333333333","4","2","0","2","6","60.00"
"695","Oskar Steen","BOS","C","20","208.21666666667","2","4","3","1","6","85.71"
"699","Casey Fitzgerald","BUF","D","36","548.73333333333","0","6","3","3","6","31.58"
"705","Michael Carcone","ARI","L","21","248.33333333333","4","2","1","1","6","85.71"
"707","Matt Luff","NSH","R","23","209.95","3","3","3","0","6","60.00"
"732","Jake Leschyshyn","VGK","C","41","425.91666666667","2","4","3","1","6","46.15"
"742","Jonas Rondbjerg","VGK","R","30","281.8","2","4","2","2","6","60.00"
"769","Scott Reedy","S.J","C","35","330.7","4","2","1","1","6","75.00"
"784","Calle Rosen","STL","D","18","244.3","2","4","1","3","6","50.00"
"886","Reese Johnson","CHI","C","37","343.36666666667","1","5","1","4","6","100.00"
"913","Cam York","PHI","D","30","454.7","2","4","2","2","6","33.33"
"934","Jordan Spence","L.A","D","24","399.23333333333","2","4","1","3","6","40.00"
"976","Cole Perfetti","WPG","C","18","230.18333333333","2","4","4","0","6","85.71"
"982","Radim Zohorna","PIT","L","17","166.5","2","4","3","1","6","46.15"
"70","Paul Byron","MTL","L","27","283.11666666667","3","2","0","2","5","71.43"
"126","Tyler Johnson","CHI","C","26","271.38333333333","3","2","1","1","5","55.56"
"185","Patrik Nemeth","NYR","D","63","923.06666666667","2","3","2","1","5","17.86"
"254","Joel Edmundson","MTL","D","24","395.58333333333","2","3","2","1","5","25.00"
"300","Mark Jankowski","BUF","C","19","212.28333333333","2","3","1","2","5","71.43"
"351","Kurtis MacDermid","COL","D","58","420.45","2","3","2","1","5","27.78"
"358","Carter Rowney","DET","C","26","265.3","4","1","0","1","5","45.45"
"430","Joel Hanley","DAL","D","44","489.75","2","3","3","0","5","38.46"
"450","Brendan Perlini","EDM","L","23","187.68333333333","4","1","1","0","5","83.33"
"475","Mark Friedman","PIT","D","26","314.98333333333","1","4","1","3","5","38.46"
"477","William Lagesson","EDM, MTL","D","33","379.05","0","5","0","5","5","29.41"
"557","Kyle Capobianco","ARI","D","45","661.9","0","5","3","2","5","18.52"
"672","Brett Murray","BUF","L","19","234.3","2","3","2","1","5","62.50"
"700","Dylan Gambrell","OTT","C","63","663.75","2","3","2","1","5","29.41"
"711","Jeffrey Viel","S.J","L","34","294.6","3","2","1","1","5","83.33"
"712","Alex Barré-Boulet","SEA, T.B","C","16","145.81666666667","3","2","2","0","5","71.43"
"719","Vinni Lettieri","ANA","C","31","332.98333333333","3","2","2","0","5","62.50"
"721","Nolan Patrick","VGK","C","25","242.3","2","3","2","1","5","62.50"
"764","Dylan Samberg","WPG","D","15","210.1","0","5","1","4","5","45.45"
"776","Erik Brannstrom","OTT","D","53","846.78333333333","0","5","3","2","5","22.73"
"801","Morgan Barron","NYR, WPG","C","27","255.51666666667","2","3","1","2","5","83.33"
"869","Connor Dewar","MIN","C","35","314.38333333333","2","3","3","0","5","50.00"
"884","Simon Benoit","ANA","D","53","702.25","1","4","1","3","5","20.83"
"893","Joe Snively","WSH","C","12","133.25","3","2","1","1","5","62.50"
"894","Corey Schueneman","MTL","D","24","351.18333333333","2","3","2","1","5","50.00"
"898","Brett Leason","WSH","R","36","320.7","3","2","1","1","5","55.56"
"953","Drew O'Connor","PIT","L","22","202.41666666667","3","2","1","1","5","62.50"
"995","Matty Beniers","SEA","C","10","131.26666666667","1","4","3","1","5","83.33"
"26","Andrej Sekera","DAL","D","32","406.83333333333","1","3","1","2","4","33.33"
"74","Riley Nash","ARI, T.B, WPG","C","49","451.9","0","4","3","1","4","44.44"
"76","Kyle Turris","EDM","C","23","185.3","1","3","0","3","4","100.00"
"79","Colton Sceviour","EDM","C","35","272.81666666667","2","2","1","1","4","44.44"
"82","Robert Bortuzzo","STL","D","73","834.78333333333","1","3","0","3","4","17.39"
"113","Michael Stone","CGY","D","11","167.68333333333","1","3","0","3","4","57.14"
"132","Kyle Clifford","STL, TOR","L","25","213.15","1","3","1","2","4","50.00"
"174","Matt Irwin","WSH","D","17","203.45","1","3","0","3","4","33.33"
"182","Greg McKegg","NYR","C","43","405.38333333333","2","2","1","1","4","57.14"
"187","Tyler Pitlick","CGY, MTL","C","39","398.31666666667","1","3","1","2","4","44.44"
"253","Brett Ritchie","CGY","R","41","391.6","3","1","1","0","4","30.77"
"308","Derrick Pouliot","SEA, VGK","D","11","168.21666666667","0","4","3","1","4","40.00"
"310","Slater Koekkoek","EDM","D","19","204.18333333333","0","4","2","2","4","33.33"
"363","Kyle Burroughs","VAN","D","42","512.26666666667","1","3","1","2","4","30.77"
"375","John Hayden","BUF","C","55","554.91666666667","2","2","0","2","4","40.00"
"445","Haydn Fleury","SEA","D","36","530.88333333333","2","2","1","1","4","22.22"
"495","Sammy Blais","NYR","L","14","169.66666666667","0","4","3","1","4","50.00"
"582","Colton White","N.J","D","27","347.83333333333","0","4","1","3","4","23.53"
"599","Sami Niku","MTL","D","13","164.78333333333","0","4","4","0","4","50.00"
"605","Philippe Myers","NSH","D","27","362.35","1","3","2","1","4","30.77"
"680","Drake Caggiula","BUF","C","18","225.81666666667","2","2","2","0","4","50.00"
"692","Axel Jonsson-Fjallby","WSH","L","23","238.98333333333","2","2","2","0","4","57.14"
"747","Gabriel Vilardi","L.A","C","25","288.85","3","1","0","1","4","50.00"
"797","Marian Studenic","DAL, N.J","L, R","33","342.65","2","2","0","2","4","44.44"
"808","Mark Kastelic","OTT","C","16","142.63333333333","2","2","1","1","4","80.00"
"846","Ryan Merkley","S.J","D","39","523.03333333333","1","3","3","0","4","30.77"
"861","Calen Addison","MIN","D","15","176.76666666667","2","2","1","1","4","40.00"
"868","Nathan Smith","ARI","C","10","120.5","2","2","1","1","4","66.67"
"877","Jesse Ylonen","MTL","R","14","141.18333333333","2","2","2","0","4","44.44"
"899","Nolan Foote","N.J","L","7","68.183333333333","3","1","1","0","4","80.00"
"900","Ronnie Attard","PHI","D","15","213.66666666667","2","2","2","0","4","33.33"
"923","Ville Heinola","WPG","D","12","162.85","0","4","1","3","4","66.67"
"924","Lassi Thomson","OTT","D","16","231.1","0","4","1","3","4","36.36"
"927","Thomas Harley","DAL","D","34","457.73333333333","1","3","2","1","4","23.53"
"939","Arttu Ruotsalainen","BUF","C","18","188.06666666667","2","2","2","0","4","80.00"
"947","Matias Maccelli","ARI","L","23","287.13333333333","1","3","0","3","4","57.14"
"973","Thomas Bordeleau","S.J","C","8","101.66666666667","0","4","4","0","4","80.00"
"16","Nate Thompson","PHI","C","33","314.86666666667","1","2","2","0","3","37.50"
"119","Mark Borowiecki","NSH","D","57","632.53333333333","0","3","1","2","3","15.79"
"164","Kevin Connauton","FLA, PHI","D","39","482.36666666667","1","2","1","1","3","13.64"
"170","Justin Dowling","VAN","C","22","191.96666666667","1","2","2","0","3","75.00"
"232","Nick Seeler","PHI","D","43","517.7","1","2","0","2","3","16.67"
"241","Logan Shaw","OTT","R","17","137.51666666667","1","2","1","1","3","50.00"
"243","Josh Leivo","CAR","L","7","64.316666666667","1","2","1","1","3","60.00"
"273","Nathan Beaulieu","WPG","D","24","208.31666666667","0","3","3","0","3","60.00"
"287","Matt Tennyson","NSH","D","8","99.05","0","3","2","1","3","60.00"
"290","Ryan Murray","COL","D","37","469","0","3","1","2","3","17.65"
"321","Jujhar Khaira","CHI","L","27","310.26666666667","3","0","0","0","3","60.00"
"350","Liam O'Brien","ARI","C","39","361.58333333333","2","1","1","0","3","42.86"
"352","Jayson Megna","COL","C","20","191.68333333333","0","3","2","1","3","60.00"
"504","Hayden Hodgson","PHI","R","6","75.216666666667","1","2","1","1","3","75.00"
"533","Thomas Novak","NSH","C","27","267.56666666667","0","3","1","2","3","50.00"
"573","Tanner Kero","DAL","C","23","206.35","0","3","1","2","3","75.00"
"602","Jalen Chatfield","CAR","D","16","227.3","0","3","1","2","3","42.86"
"604","Adam Brooks","MTL, VGK, WPG","C","25","213.08333333333","2","1","1","0","3","60.00"
"662","Dennis Cholowski","SEA, WSH","D","11","160.48333333333","0","3","0","3","3","30.00"
"677","Troy Stecher","DET, L.A","D","29","445.36666666667","1","2","1","1","3","23.08"
"725","Jonah Gadjovich","S.J","L","43","372.53333333333","1","2","2","0","3","33.33"
"738","Urho Vaakanainen","ANA, BOS","D","29","493.16666666667","0","3","2","1","3","13.04"
"741","Kristian Vesalainen","WPG","L","53","448.15","2","1","0","1","3","25.00"
"751","Jack Studnicka","BOS","C","15","173.23333333333","0","3","2","1","3","100.00"
"774","Robin Salo","NYI","D","21","310.61666666667","1","2","2","0","3","42.86"
"791","Jacob Bryson","BUF","D","73","1165.5833333333","0","3","2","1","3","6.25"
"802","Carson Meyer","CBJ","R","13","105.28333333333","1","2","2","0","3","100.00"
"850","Jack McBain","ARI","C","10","113.16666666667","2","1","0","1","3","42.86"
"852","Kevin Bahl","N.J","D","17","244.1","1","2","1","1","3","30.00"
"863","Jan Jenik","ARI","R","13","130.55","2","1","0","1","3","75.00"
"916","Bobby Brink","PHI","R","10","116.16666666667","0","3","2","1","3","75.00"
"930","Philip Broberg","EDM","D","23","277.13333333333","1","2","0","2","3","30.00"
"935","Vladislav Kolyachonok","ARI","D","32","487.53333333333","1","2","2","0","3","15.79"
"997","Owen Power","BUF","D","8","142.91666666667","2","1","1","0","3","33.33"
"1002","Marc McLaughlin","BOS","C","11","111.51666666667","3","0","0","0","3","75.00"
"35","James Neal","STL","L","19","192.33333333333","1","1","0","1","2","50.00"
"77","Brad Malone","EDM","C","8","55","1","1","1","0","2","100.00"
"94","Jay Beagle","ARI","C","33","370.61666666667","1","1","1","0","2","40.00"
"118","Greg Pateryn","ANA","D","10","112.63333333333","1","1","1","0","2","33.33"
"142","Ryan Ellis","PHI","D","4","68.25","1","1","1","0","2","100.00"
"218","Michael Sgarbossa","WSH","C","10","91.15","1","1","1","0","2","50.00"
"319","Mackenzie MacEachern","STL","L","14","109.8","0","2","2","0","2","100.00"
"337","Cedric Paquette","MTL","C","24","165.2","0","2","1","1","2","66.67"
"353","Scott Sabourin","OTT","R","7","52.916666666667","0","2","2","0","2","66.67"
"369","Tucker Poolman","VAN","D","40","592.95","1","1","0","1","2","11.76"
"372","Jonny Brodzinski","NYR","C","22","215.33333333333","1","1","0","1","2","40.00"
"400","Carl Dahlstrom","TOR","D","3","38.3","0","2","2","0","2","100.00"
"494","Kevin Labanc","S.J","R","21","234.96666666667","1","1","1","0","2","50.00"
"514","Colin White","OTT","C","24","294.55","0","2","1","1","2","25.00"
"522","Jakub Zboril","BOS","D","10","145.61666666667","0","2","0","2","2","33.33"
"525","A.J. Greer","N.J","L","9","70.45","1","1","0","1","2","66.67"
"541","Nick Merkley","S.J","R","9","98.966666666667","1","1","1","0","2","50.00"
"545","Noah Juulsen","VAN","D","8","104.28333333333","0","2","1","1","2","66.67"
"601","Lane Pederson","S.J","C","29","281.28333333333","0","2","1","1","2","100.00"
"612","Kyle Criscuolo","DET","C","6","57.083333333333","0","2","1","1","2","100.00"
"635","Tyler Benson","EDM","L","29","242.3","1","1","1","0","2","33.33"
"674","Jacob Moverare","L.A","D","19","278.85","0","2","1","1","2","20.00"
"681","Michal Kempny","WSH","D","15","216.75","1","1","0","1","2","40.00"
"690","Otto Koivula","NYI","L","8","76.466666666667","0","2","1","1","2","66.67"
"704","Jeremy Davies","NSH","D","6","71.8","0","2","1","1","2","100.00"
"722","Juuso Valimaki","CGY","D","9","130.2","0","2","1","1","2","40.00"
"750","Isaac Ratcliffe","PHI","L","10","96.3","1","1","1","0","2","100.00"
"785","Radim Simek","S.J","D","36","457.38333333333","1","1","1","0","2","20.00"
"800","Alexei Toropchenko","STL","R","28","294.38333333333","2","0","0","0","2","33.33"
"806","Sheldon Dries","VAN","C","11","100.58333333333","1","1","1","0","2","50.00"
"811","Trey Fix-Wolansky","CBJ","R","6","37.366666666667","1","1","0","1","2","66.67"
"812","Kristian Reichel","WPG","C","13","132.33333333333","1","1","0","1","2","66.67"
"816","Austin Strand","L.A","D","8","110.7","0","2","1","1","2","50.00"
"818","Kiefer Sherwood","COL","L","11","87.316666666667","1","1","0","1","2","40.00"
"840","Jack Drury","CAR","C","2","28.433333333333","2","0","0","0","2","66.67"
"855","Benoit-Olivier Groulx","ANA","C","18","164.26666666667","0","2","1","1","2","50.00"
"858","Nils Lundkvist","NYR","D","25","309.36666666667","0","2","1","1","2","15.38"
"870","Riley Damiani","DAL","C","7","56.316666666667","1","1","1","0","2","100.00"
"876","Paul Cotter","VGK","C","7","60.483333333333","2","0","0","0","2","66.67"
"878","Scott Perunovich","STL","D","19","240.23333333333","0","2","1","1","2","20.00"
"892","Taro Hirose","DET","L","15","134.08333333333","0","2","1","1","2","40.00"
"910","Nikita Okhotiuk","N.J","D","5","74.016666666667","1","1","0","1","2","66.67"
"922","Alex Vlasic","CHI","D","15","203.56666666667","1","1","1","0","2","22.22"
"944","Santeri Hatakka","S.J","D","9","109.71666666667","0","2","1","1","2","50.00"
"946","Zac Jones","NYR","D","12","168.73333333333","0","2","0","2","2","66.67"
"962","Jake Neighbours","STL","L","9","79.366666666667","1","1","1","0","2","66.67"
"967","Justin Barron","COL, MTL","D","7","101.61666666667","1","1","0","1","2","40.00"
"989","Mike Hardman","CHI","L","21","188.05","0","2","1","1","2","40.00"
"990","Matt Kiersted","FLA","D","10","130.98333333333","1","1","1","0","2","50.00"
"999","Mason McTavish","ANA","C","9","96.883333333333","2","0","0","0","2","40.00"
"1003","Nick Blankenburg","CBJ","D","7","109.66666666667","0","2","0","2","2","100.00"
"24","Blake Comeau","DAL","L","6","61.966666666667","1","0","0","0","1","50.00"
"203","Brett Connolly","CHI","R","9","68.6","0","1","1","0","1","100.00"
"207","Jarred Tinordi","NYR","D","7","87.333333333333","1","0","0","0","1","100.00"
"221","Matthew Peca","STL","C","5","46.966666666667","0","1","0","1","1","inf"
"226","Josh Archibald","EDM","R","8","59.916666666667","0","1","1","0","1","50.00"
"235","Joseph Cramarossa","MIN","C","1","6.9166666666667","0","1","0","1","1","100.00"
"242","Andy Andreoff","NYI","C","6","58.583333333333","1","0","0","0","1","100.00"
"250","Dmitrij Jaskin","ARI","R","12","154.21666666667","0","1","1","0","1","25.00"
"257","Scott Harrington","CBJ","D","7","91.466666666667","0","1","0","1","1","50.00"
"335","Gemel Smith","DET","C","3","20.116666666667","0","1","0","1","1","100.00"
"340","Danny O'Regan","ANA","C","5","50.283333333333","0","1","1","0","1","100.00"
"343","Petteri Lindbohm","FLA","D","9","123.13333333333","0","1","0","1","1","20.00"
"386","Ben Harpur","NSH","D","19","233.85","0","1","0","1","1","25.00"
"398","Nic Petan","VAN","C","18","169.03333333333","0","1","1","0","1","50.00"
"487","Clark Bishop","OTT","C","9","72.65","0","1","0","1","1","100.00"
"496","Dylan Sikura","COL","C","5","47.133333333333","0","1","1","0","1","50.00"
"503","Bokondji Imama","ARI","L","4","17.45","1","0","0","0","1","50.00"
"536","Cooper Marody","EDM","C","1","5.8833333333333","0","1","1","0","1","100.00"
"563","Jacob Larsson","ANA","D","6","89.25","0","1","0","1","1","50.00"
"580","Lukas Vejdemo","MTL","C","6","48.866666666667","1","0","0","0","1","100.00"
"583","Christian Wolanin","BUF, L.A","D","9","117.65","0","1","1","0","1","33.33"
"597","Markus Nutivaara","FLA","D","1","6.85","0","1","1","0","1","100.00"
"609","Ethan Prow","BUF","D","4","46.016666666667","1","0","0","0","1","33.33"
"618","Lucas Johansen","WSH","D","1","11.316666666667","0","1","1","0","1","100.00"
"624","Libor Hajek","NYR","D","17","214.61666666667","0","1","0","1","1","25.00"
"628","Markus Niemelainen","EDM","D","20","231.08333333333","0","1","0","1","1","16.67"
"641","Beck Malenstyn","WSH","L","12","99.65","1","0","0","0","1","20.00"
"642","Riley Tufte","DAL","L","10","70.083333333333","1","0","0","0","1","50.00"
"683","Kasper Bjorkqvist","PIT","R","6","43.7","1","0","0","0","1","100.00"
"685","Garrett Pilon","WSH","C","2","18.05","1","0","0","0","1","100.00"
"686","Fredrik Karlstrom","DAL","C","3","17.883333333333","0","1","1","0","1","50.00"
"691","Linus Hogberg","PHI","D","5","79.383333333333","0","1","0","1","1","100.00"
"709","Mathieu Olivier","NSH","R","10","92.233333333333","0","1","1","0","1","100.00"
"735","Cody Glass","NSH","C","8","74.866666666667","0","1","0","1","1","100.00"
"766","Reilly Walsh","N.J","D","1","13.4","0","1","0","1","1","100.00"
"775","Lias Andersson","L.A","C","20","195.55","1","0","0","0","1","33.33"
"804","Jayden Halbgewachs","S.J","L","3","36.966666666667","0","1","1","0","1","33.33"
"805","Grant Hutton","NYI","D","16","212.08333333333","1","0","0","0","1","16.67"
"807","Sean Walker","L.A","D","6","89.433333333333","0","1","1","0","1","50.00"
"839","Alec Regula","CHI","D","15","230.88333333333","1","0","0","0","1","10.00"
"853","Gabriel Fortier","T.B","L","10","89.366666666667","1","0","0","0","1","100.00"
"859","Jacob Bernard-Docker","OTT","D","8","114.36666666667","0","1","1","0","1","16.67"
"862","Jordan Harris","MTL","D","10","152.8","1","0","0","0","1","12.50"
"866","Juuso Riikola","PIT","D","5","57.416666666667","0","1","0","1","1","25.00"
"873","Josiah Slavin","CHI","L","15","162.9","0","1","1","0","1","50.00"
"881","John Leonard","S.J","L","14","144.36666666667","1","0","0","0","1","50.00"
"882","Rafael Harvey-Pinard","MTL","L","4","43.633333333333","1","0","0","0","1","33.33"
"887","Jake Christiansen","CBJ","D","8","75.366666666667","1","0","0","0","1","33.33"
"918","Mattias Norlinder","MTL","D","6","71.866666666667","0","1","0","1","1","33.33"
"928","Nicholas Robertson","TOR","L","10","97.883333333333","1","0","0","0","1","100.00"
"945","Valtteri Puustinen","PIT","R","1","8.7","0","1","0","1","1","50.00"
"948","Nicholas Abruzzese","TOR","C","9","82.5","1","0","0","0","1","50.00"
"956","Connor Mackey","CGY","D","3","40.216666666667","0","1","0","1","1","100.00"
"964","Jack Quinn","BUF","R","2","23.616666666667","0","1","0","1","1","100.00"
"970","Lukas Reichel","CHI","L","11","124.33333333333","0","1","0","1","1","100.00"
"972","Alexander Holtz","N.J","R","9","90.033333333333","0","1","1","0","1","50.00"
"975","Hendrix Lapierre","WSH","C","6","51.8","1","0","0","0","1","33.33"
"987","Daniil Miromanov","VGK","D","11","104.08333333333","0","1","0","1","1","25.00"
"988","Alex Steeves","TOR","C","3","23.916666666667","0","1","0","1","1","100.00"
"992","Jackson Cates","PHI","C","11","93.383333333333","1","0","0","0","1","33.33"
"994","Kent Johnson","CBJ","C","9","98.65","0","1","1","0","1","25.00"
"996","William Eklund","S.J","C, L","9","108.05","0","1","1","0","1","100.00"
"1001","Jesper Froden","BOS","R","7","79.85","1","0","0","0","1","25.00"
"1004","Ben Meyers","COL","C","5","48.65","1","0","0","0","1","100.00"
"45","Alex Biega","TOR","D","2","25.583333333333","0","0","0","0","0","-"
"51","Leo Komarov","NYI","R","1","10.833333333333","0","0","0","0","0","-"
"75","Thomas Hickey","NYI","D","2","32.483333333333","0","0","0","0","0","-"
"109","Zac Dalpe","FLA","C","1","6.1333333333333","0","0","0","0","0","-"
"123","Luke Witkowski","DET","D","1","9.3","0","0","0","0","0","-"
"148","John Moore","BOS","D","7","97.333333333333","0","0","0","0","0","0.00"
"155","Richard Panik","NYI","R","4","45.433333333333","0","0","0","0","0","-"
"172","Andrew Agozzino","OTT","L","1","6.8666666666667","0","0","0","0","0","-"
"198","Chris Wagner","BOS","R","1","13.266666666667","0","0","0","0","0","-"
"219","Alex Belzile","MTL","R","11","96.566666666667","0","0","0","0","0","0.00"
"225","Max McCormick","SEA","L","10","78.316666666667","0","0","0","0","0","0.00"
"231","Fredrik Claesson","T.B","D","9","85.366666666667","0","0","0","0","0","0.00"
"236","T.J. Tynan","L.A","C","2","17.3","0","0","0","0","0","-"
"239","Steven Fogarty","BOS","C","2","20.383333333333","0","0","0","0","0","-"
"244","Kyle Rau","MIN","C","5","40.766666666667","0","0","0","0","0","-"
"247","Rocco Grimaldi","NSH","R","7","63.816666666667","0","0","0","0","0","0.00"
"269","Sven Baertschi","VGK","L","1","13.866666666667","0","0","0","0","0","-"
"275","Stefan Noesen","CAR","R","2","26.016666666667","0","0","0","0","0","0.00"
"279","Seth Griffith","EDM","C","1","5.6166666666667","0","0","0","0","0","0.00"
"280","Turner Elson","DET","C","2","26.65","0","0","0","0","0","0.00"
"283","Kurtis Gabriel","CHI","R","2","12.05","0","0","0","0","0","-"
"297","Stefan Matteau","COL","C","1","3.65","0","0","0","0","0","-"
"327","Martin Frk","L.A","R","6","58.5","0","0","0","0","0","-"
"341","Paul LaDue","NYI","D","1","11.05","0","0","0","0","0","-"
"345","Riley Barber","DET","R","4","29.933333333333","0","0","0","0","0","0.00"
"365","Tyler Lewington","BOS","D","2","22.033333333333","0","0","0","0","0","-"
"374","Hudson Fasching","ARI","R","11","105.83333333333","0","0","0","0","0","-"
"382","Mason Geertsen","N.J","D","25","173.31666666667","0","0","0","0","0","0.00"
"383","Miles Wood","N.J","L","3","38.75","0","0","0","0","0","-"
"396","Remi Elie","T.B","L","1","9.7333333333333","0","0","0","0","0","-"
"399","Dillon Heatherington","OTT","D","9","93.366666666667","0","0","0","0","0","0.00"
"401","Justin Bailey","VAN","R","14","108.08333333333","0","0","0","0","0","0.00"
"402","Madison Bowey","VAN","D","2","25.75","0","0","0","0","0","-"
"425","Frederik Gauthier","N.J","C","8","65.966666666667","0","0","0","0","0","-"
"427","Dakota Mermis","MIN","D","2","27.4","0","0","0","0","0","0.00"
"429","Brandon Baddock","MTL","L","1","7.4333333333333","0","0","0","0","0","-"
"444","Michael Dal Colle","NYI","L","1","13.733333333333","0","0","0","0","0","0.00"
"466","Ryan MacInnis","BUF","C","1","10","0","0","0","0","0","-"
"478","Chase De Leo","N.J","C","2","16.3","0","0","0","0","0","-"
"480","Austin Poganski","WPG","R","16","146.16666666667","0","0","0","0","0","0.00"
"489","CJ Suess","WPG","L","3","16.516666666667","0","0","0","0","0","-"
"492","Anthony Angello","PIT","R","4","26.516666666667","0","0","0","0","0","0.00"
"505","Darren Raddysh","T.B","D","4","41.266666666667","0","0","0","0","0","0.00"
"508","Vladimir Tkachev","L.A","L","4","44.383333333333","0","0","0","0","0","-"
"527","Brendan Guhle","ANA","D","6","85.633333333333","0","0","0","0","0","0.00"
"540","Glenn Gawdin","CGY","C","2","18.2","0","0","0","0","0","-"
"550","Guillaume Brisebois","VAN","D","1","4.2166666666667","0","0","0","0","0","-"
"559","Blake Speers","ARI","C","2","17.716666666667","0","0","0","0","0","-"
"561","Zach Senyshyn","OTT","R","2","13.05","0","0","0","0","0","-"
"562","Chase Pearson","DET","C","3","20.266666666667","0","0","0","0","0","0.00"
"579","Kevin Stenlund","CBJ","C","3","22.583333333333","0","0","0","0","0","-"
"589","Christian Jaros","N.J","D","11","116.91666666667","0","0","0","0","0","0.00"
"593","Brett Seney","TOR","L","2","13.55","0","0","0","0","0","-"
"600","Kole Sherwood","NSH","R","1","8.1333333333333","0","0","0","0","0","-"
"607","Andrew Poturalski","CAR","C","2","17.233333333333","0","0","0","0","0","-"
"608","Dan Renouf","DET","D","4","55.266666666667","0","0","0","0","0","0.00"
"614","Joey Anderson","TOR","R","5","42.933333333333","0","0","0","0","0","0.00"
"617","Maxime Lajoie","CAR","D","5","56.716666666667","0","0","0","0","0","0.00"
"619","Wade Allison","PHI","R","1","7.0833333333333","0","0","0","0","0","-"
"639","Olli Juolevi","DET, FLA","D","18","218","0","0","0","0","0","0.00"
"643","Tim Gettinger","NYR","L","8","73.183333333333","0","0","0","0","0","0.00"
"646","William Lockwood","VAN","R","13","144.91666666667","0","0","0","0","0","0.00"
"647","Max Jones","ANA","L","2","17.333333333333","0","0","0","0","0","-"
"656","Connor Bunnaman","PHI","C","15","143.66666666667","0","0","0","0","0","0.00"
"669","Sean Day","T.B","D","2","19.916666666667","0","0","0","0","0","0.00"
"676","Jacob MacDonald","COL","D","8","73.65","0","0","0","0","0","0.00"
"678","Anthony Greco","NYR","R","1","9.7333333333333","0","0","0","0","0","-"
"696","Tanner Laczynski","PHI","C","1","9.1666666666667","0","0","0","0","0","-"
"698","Mikhail Maltsev","COL","L","18","136.36666666667","0","0","0","0","0","0.00"
"701","Rhett Gardner","DAL","C","4","32.416666666667","0","0","0","0","0","-"
"702","Michael Eyssimont","WPG","C","1","5.8166666666667","0","0","0","0","0","-"
"703","Chase Priskie","FLA","D","4","53.15","0","0","0","0","0","0.00"
"713","Kristians Rubins","TOR","D","3","33.983333333333","0","0","0","0","0","0.00"
"720","Mason Shaw","MIN","C","3","26.966666666667","0","0","0","0","0","-"
"726","Conor Timmins","ARI","D","6","93.216666666667","0","0","0","0","0","0.00"
"729","Cale Fleury","SEA","D","9","126.96666666667","0","0","0","0","0","0.00"
"734","Jaret Anderson-Dolan","L.A","C","7","90.433333333333","0","0","0","0","0","-"
"760","Aleksi Heponiemi","FLA","C","6","81.466666666667","0","0","0","0","0","-"
"762","Dmitri Samorukov","EDM","D","1","2.4666666666667","0","0","0","0","0","-"
"767","Jack Rathbone","VAN","D","9","115.26666666667","0","0","0","0","0","0.00"
"768","Pierre-Olivier Joseph","PIT","D","4","68.866666666667","0","0","0","0","0","0.00"
"773","Ian Mitchell","CHI","D","8","86.183333333333","0","0","0","0","0","0.00"
"779","C.J. Smith","CAR","L","1","9.3","0","0","0","0","0","-"
"780","Mike Vecchione","WSH","R","1","5.1","0","0","0","0","0","-"
"790","Johnathan Kovacevic","WPG","D","4","41.783333333333","0","0","0","0","0","0.00"
"798","Jakub Galvas","CHI","D","6","87.966666666667","0","0","0","0","0","0.00"
"799","Ben Jones","VGK","C","2","15.883333333333","0","0","0","0","0","0.00"
"803","Wyatt Kalynuk","CHI","D","5","57.6","0","0","0","0","0","0.00"
"809","Alexander True","SEA","C","8","65.4","0","0","0","0","0","0.00"
"815","Joey Keane","CAR","D","1","13.616666666667","0","0","0","0","0","-"
"820","Sheldon Rempal","VAN","R","1","9.1833333333333","0","0","0","0","0","-"
"832","Nicolas Beaudin","CHI","D","2","11.466666666667","0","0","0","0","0","-"
"835","Martin Kaut","COL","R","6","42.416666666667","0","0","0","0","0","0.00"
"836","Alexander Alexeyev","WSH","D","1","9.9666666666667","0","0","0","0","0","-"
"842","Filip Hallander","PIT","C","1","5.8666666666667","0","0","0","0","0","-"
"843","Grigori Denisenko","FLA","L","1","14.333333333333","0","0","0","0","0","-"
"845","Sampo Ranta","COL","L","10","91.633333333333","0","0","0","0","0","0.00"
"847","Ty Dellandrea","DAL","C","1","10.616666666667","0","0","0","0","0","-"
"849","Liam Foudy","CBJ","C","1","11.083333333333","0","0","0","0","0","-"
"851","Cameron Hillis","MTL","C","1","9.2333333333333","0","0","0","0","0","-"
"865","Jordan Gross","COL","D","1","8.3166666666667","0","0","0","0","0","-"
"871","Declan Chisholm","WPG","D","2","25.866666666667","0","0","0","0","0","0.00"
"872","Hunter Drew","ANA","D","2","19.716666666667","0","0","0","0","0","-"
"875","David Gustafsson","WPG","C","2","4.9333333333333","0","0","0","0","0","-"
"883","Egor Sokolov","OTT","L","8","75.733333333333","0","0","0","0","0","0.00"
"885","Cole Reinhardt","OTT","L","1","8.5833333333333","0","0","0","0","0","-"
"888","Brayden Pachal","VGK","D","2","19.516666666667","0","0","0","0","0","-"
"889","Egor Zamula","PHI","D","10","149.61666666667","0","0","0","0","0","0.00"
"891","Samuel Fagemo","L.A","L","4","47.716666666667","0","0","0","0","0","0.00"
"897","Jon Lizotte","MIN","D","1","13.316666666667","0","0","0","0","0","0.00"
"904","Kaedan Korczak","VGK","D","1","15.216666666667","0","0","0","0","0","-"
"906","Brayden Tracey","ANA","L","1","9.35","0","0","0","0","0","-"
"907","Alex Turcotte","L.A","C","8","86.483333333333","0","0","0","0","0","0.00"
"914","Adam Beckman","MIN","L","3","26.5","0","0","0","0","0","-"
"915","Artemi Kniazev","S.J","D","1","11.4","0","0","0","0","0","-"
"929","Shane Pinto","OTT","C","5","52.283333333333","0","0","0","0","0","0.00"
"931","Victor Soderstrom","ARI","D","16","230.13333333333","0","0","0","0","0","0.00"
"933","Pavel Dorofeyev","VGK","L","2","13","0","0","0","0","0","-"
"941","Cole Schwindt","FLA","C","3","41.516666666667","0","0","0","0","0","-"
"943","Viktor Lodin","OTT","C","1","8.85","0","0","0","0","0","-"
"949","Tyce Thompson","N.J","R","2","26.216666666667","0","0","0","0","0","-"
"950","Bryce Kindopp","ANA","R","1","6.1","0","0","0","0","0","-"
"951","Ben McCartney","ARI","L","2","26.683333333333","0","0","0","0","0","0.00"
"952","Zachary Hayes","VGK","D","3","31.716666666667","0","0","0","0","0","-"
"954","Brandon Biro","BUF","L","1","11.716666666667","0","0","0","0","0","-"
"955","Cole Smith","NSH","L","8","64.516666666667","0","0","0","0","0","0.00"
"957","Mitchell Chaffee","MIN","R","2","14.9","0","0","0","0","0","0.00"
"958","Jack Ahcan","BOS","D","6","88.783333333333","0","0","0","0","0","-"
"961","Marco Rossi","MIN","C","2","24","0","0","0","0","0","-"
"977","Jacob Perreault","ANA","R","1","9.95","0","0","0","0","0","-"
"978","JJ Peterka","BUF","R","2","30.05","0","0","0","0","0","0.00"
"979","Isaak Phillips","CHI","D","4","46.15","0","0","0","0","0","0.00"
"980","Adam Raska","S.J","R","5","38.05","0","0","0","0","0","0.00"
"983","Linus Sandin","PHI","R","1","6.6833333333333","0","0","0","0","0","-"
"985","Jeff Malott","WPG","L","1","4.1","0","0","0","0","0","-"
"991","Walker Duehr","CGY","R","1","8.7833333333333","0","0","0","0","0","-"
"1000","Kirill Semyonov","TOR","C","3","27.15","0","0","0","0","0","0.00"