"","Player","Team","Position","GP","TOI","Goals","Total Assists","First Assists","Second Assists","Total Points","IPP"
"334","Nathan MacKinnon","COL","C","71","1189.7333333333","25","40","30","10","65","80.25"
"76","Erik Karlsson","S.J","D","82","1667.8","16","48","29","19","64","66.67"
"384","David Pastrnak","BOS","R","82","1185.8333333333","34","27","14","13","61","83.56"
"397","Brayden Point","T.B","C","82","1203.25","29","30","16","14","59","79.73"
"438","Connor McDavid","EDM","C","82","1308.2666666667","32","27","20","7","59","78.67"
"519","Matthew Tkachuk","FLA","L","79","1120.9333333333","22","36","22","14","58","65.17"
"159","Jeff Skinner","BUF","L","79","1071.8833333333","25","31","19","12","56","70.00"
"637","Elias Pettersson","VAN","C","80","1100.6","21","35","20","15","56","86.15"
"644","Jason Robertson","DAL","L","82","1186.4833333333","26","30","19","11","56","78.87"
"812","Jack Hughes","N.J","C","78","1201.7666666667","28","28","18","10","56","78.87"
"17","Sidney Crosby","PIT","C","82","1240.9166666667","22","33","19","14","55","82.09"
"574","Tage Thompson","BUF","C, R","78","1066.8166666667","25","30","20","10","55","80.88"
"447","Mikko Rantanen","COL","R","82","1357.7333333333","32","21","14","7","53","70.67"
"478","Mitchell Marner","TOR","R","80","1143.8833333333","15","38","28","10","53","82.81"
"537","Clayton Keller","ARI","R","82","1290.8333333333","24","29","23","6","53","81.54"
"309","Carter Verhaeghe","FLA","C","81","1148.1833333333","28","24","11","13","52","76.47"
"522","Auston Matthews","TOR","C","74","1145.7833333333","26","26","19","7","52","69.33"
"207","Nikita Kucherov","T.B","R","82","1226.7666666667","15","36","20","16","51","70.83"
"367","Leon Draisaitl","EDM","C","80","1269.7166666667","17","34","29","5","51","68.92"
"491","Artemi Panarin","NYR","L","82","1224.2","19","31","19","12","50","79.37"
"370","William Nylander","TOR","R","82","1124.75","22","27","13","14","49","76.56"
"947","Andrei Kuzmenko","VAN","L","81","1023.7333333333","21","28","11","17","49","76.56"
"149","Brock Nelson","NYI","C","82","1128.8333333333","24","24","14","10","48","67.61"
"160","Zach Hyman","EDM","L","79","1216.05","15","33","20","13","48","60.76"
"378","Alex Tuch","BUF","R","74","999.3","21","27","19","8","48","72.73"
"383","Jared McCann","SEA","L","79","968.98333333333","30","18","14","4","48","71.64"
"19","Anze Kopitar","L.A","C","82","1166.9333333333","17","29","16","13","46","76.67"
"874","Tim Stützle","OTT","L","78","1157.55","20","26","15","11","46","74.19"
"631","Nico Hischier","N.J","C","81","1067.5333333333","14","31","21","10","45","73.77"
"714","Brady Tkachuk","OTT","L","82","1105.7166666667","20","25","15","10","45","75.00"
"11","Evgeni Malkin","PIT","C","82","1123.8","15","29","20","9","44","83.02"
"77","Jordan Eberle","SEA","R","82","1105.75","16","28","21","7","44","66.67"
"258","Chandler Stephenson","VGK","C","81","1128.7166666667","7","37","22","15","44","74.58"
"437","Pavel Zacha","BOS","C","82","1022.8666666667","15","28","12","16","43","66.15"
"461","Roope Hintz","DAL","C","73","929.48333333333","21","22","16","6","43","74.14"
"570","Jesper Bratt","N.J","L","82","1110.9166666667","20","23","14","9","43","68.25"
"37","Claude Giroux","OTT","R","82","1138.7333333333","23","19","14","5","42","73.68"
"434","Kyle Connor","WPG","L","82","1246.7","20","22","14","8","42","70.00"
"440","Vince Dunn","SEA","D","81","1551.5833333333","13","29","12","17","42","40.78"
"561","Jordan Kyrou","STL","C","79","1118.7","22","20","12","8","42","75.00"
"43","Alex Killorn","T.B","L","82","1023.55","19","22","11","11","41","70.69"
"44","Jamie Benn","DAL","L","82","909.55","17","24","11","13","41","69.49"
"70","Steven Stamkos","T.B","C","81","1113.25","16","25","16","9","41","65.08"
"106","Brayden Schenn","STL","C","82","1155.8166666667","12","29","16","13","41","80.39"
"504","Troy Terry","ANA","R","70","1073.3166666667","13","28","16","12","41","75.93"
"640","Nick Suzuki","MTL","C","82","1213.5166666667","14","27","15","12","41","64.06"
"801","Trevor Zegras","ANA","C","81","1217.8666666667","16","25","18","7","41","71.93"
"8","Joe Pavelski","DAL","C","82","1111.45","12","28","17","11","40","56.34"
"10","Alex Ovechkin","WSH","L","73","1041.0833333333","20","20","11","9","40","75.47"
"14","David Krejci","BOS","C","70","941.06666666667","12","28","19","9","40","68.97"
"142","Tyler Toffoli","CGY","R","82","996.06666666667","19","21","8","13","40","68.97"
"189","Vincent Trocheck","NYR","C","82","1205.5666666667","10","30","21","9","40","72.73"
"212","Mika Zibanejad","NYR","C","82","1093.9","16","24","17","7","40","78.43"
"345","Josh Morrissey","WPG","D","78","1473.35","12","28","19","9","40","53.33"
"914","Matty Beniers","SEA","C","80","1086.8","17","23","12","11","40","63.49"
"186","Johnny Gaudreau","CBJ","L","80","1204.6666666667","13","26","15","11","39","72.22"
"208","Ryan Nugent-Hopkins","EDM","C","82","1093.2333333333","16","23","11","12","39","61.90"
"213","Mark Scheifele","WPG","C","81","1261.2333333333","25","14","7","7","39","69.64"
"373","Kevin Fiala","L.A","L","69","940.51666666667","9","30","19","11","39","76.47"
"439","Jack Eichel","VGK","C","67","956.16666666667","20","19","10","9","39","69.64"
"456","Dylan Strome","WSH","C","81","1036.4833333333","17","22","11","11","39","69.64"
"629","Casey Mittelstadt","BUF","C","82","1035.65","9","30","21","9","39","72.22"
"799","Dylan Cozens","BUF","C","81","949.18333333333","21","18","13","5","39","76.47"
"342","Bo Horvat","NYI, VAN","C","79","1152.5833333333","19","19","13","6","38","71.70"
"380","Nick Schmaltz","ARI","C","63","940.76666666667","15","23","11","12","38","73.08"
"590","Brandon Hagel","T.B","L","81","1112.2166666667","17","21","10","11","38","64.41"
"102","John Tavares","TOR","C","80","1062.3666666667","16","21","11","10","37","71.15"
"108","Nazem Kadri","CGY","C","82","1082.65","13","24","14","10","37","69.81"
"141","Jason Zucker","PIT","L","78","1077.0333333333","24","13","7","6","37","68.52"
"231","Yanni Gourde","SEA","C","81","1129.7333333333","7","30","16","14","37","62.71"
"305","Pavel Buchnevich","STL","L","63","865.45","18","19","14","5","37","69.81"
"306","Jake Guentzel","PIT","L","78","1186.1666666667","16","21","16","5","37","62.71"
"450","Sebastian Aho","CAR","C","75","999.83333333333","22","15","13","2","37","69.81"
"540","Dillon Dube","CGY","C","82","994.26666666667","13","24","12","12","37","72.55"
"871","Dawson Mercer","N.J","C","82","1089.3666666667","20","17","12","5","37","67.27"
"52","Logan Couture","S.J","C","82","1042.0333333333","14","22","13","9","36","70.59"
"59","Mikael Backlund","CGY","C","82","1090.5","13","23","14","9","36","66.67"
"209","Jonathan Huberdeau","CGY","C","79","1029.4833333333","10","26","16","10","36","72.00"
"214","Dougie Hamilton","N.J","D","82","1422.55","13","23","11","12","36","44.44"
"335","Aleksander Barkov","FLA","C","68","911.61666666667","12","24","13","11","36","67.92"
"387","Ivan Barbashev","STL, VGK","C","82","1122.6833333333","12","24","12","12","36","67.92"
"406","Michael Bunting","TOR","L","82","1112.8333333333","14","22","16","6","36","55.38"
"444","Timo Meier","N.J, S.J","R","78","1181.95","22","14","9","5","36","60.00"
"645","Morgan Frost","PHI","C","81","1071.65","16","20","9","11","36","76.60"
"116","Tomas Tatar","N.J","L","82","1069.2333333333","15","20","7","13","35","57.38"
"224","Rickard Rakell","PIT","R","82","1199.9833333333","16","19","6","13","35","57.38"
"338","Elias Lindholm","CGY","C","80","994.28333333333","10","25","15","10","35","67.31"
"428","Andrew Mangiapane","CGY","L","82","1067.5333333333","15","20","13","7","35","60.34"
"458","Brock Boeser","VAN","R","74","998.36666666667","10","25","13","12","35","66.04"
"642","Robert Thomas","STL","C","73","1022.8","9","26","17","9","35","60.34"
"652","Martin Necas","CAR","C","82","1136.9833333333","13","22","19","3","35","58.33"
"665","Filip Chytil","NYR","C","74","934.7","17","18","13","5","35","72.92"
"711","Joel Farabee","PHI","L","82","1094.95","15","20","9","11","35","64.81"
"104","Matt Duchene","NSH","C","71","1000.15","12","22","11","11","34","66.67"
"115","Reilly Smith","VGK","R","78","988.1","11","23","14","9","34","72.34"
"144","Charlie Coyle","BOS","C","82","1070.1166666667","15","19","10","9","34","66.67"
"226","Jonathan Marchessault","VGK","C, R","76","1050.6666666667","16","18","11","7","34","70.83"
"310","Oliver Bjorkstrand","SEA","R","81","1046.85","15","19","10","9","34","69.39"
"385","Adrian Kempe","L.A","C, R","82","1100.05","22","12","8","4","34","68.00"
"402","Devon Toews","COL","D","80","1498.8166666667","6","28","10","18","34","43.04"
"526","Adam Fox","NYR","D","82","1435.05","8","26","12","14","34","49.28"
"674","Eetu Luostarinen","FLA","C","82","1011.8833333333","15","19","7","12","34","60.71"
"56","Patrick Kane","CHI, NYR","R","73","1097.4333333333","16","17","10","7","33","67.35"
"148","Justin Faulk","STL","D","82","1487.05","7","26","14","12","33","44.00"
"205","William Karlsson","VGK","C","82","1075","8","25","10","15","33","70.21"
"248","Tomas Hertl","S.J","C","79","1169.2833333333","13","20","10","10","33","62.26"
"392","Brandon Montour","FLA","D","80","1416.9","11","22","11","11","33","39.76"
"476","Lawson Crouse","ARI","L","77","1003.75","14","19","12","7","33","67.35"
"480","Joel Eriksson Ek","MIN","C","78","951.61666666667","7","26","16","10","33","84.62"
"502","Kirill Kaprizov","MIN","L","67","1039.0333333333","18","15","9","6","33","75.00"
"571","Mikhail Sergachev","T.B","D","79","1422.6","7","26","15","11","33","45.83"
"639","Owen Tippett","PHI","R","77","1071.35","16","17","11","6","33","63.46"
"726","Andrei Svechnikov","CAR","R","64","889.65","17","16","10","6","33","73.33"
"731","Rasmus Dahlin","BUF","D","78","1529.2833333333","9","24","14","10","33","40.24"
"893","Alexander Barabanov","S.J","L","68","978.95","12","21","13","8","33","68.75"
"926","Wyatt Johnston","DAL","C","82","1066.2833333333","21","12","8","4","33","61.11"
"12","Blake Wheeler","WPG","R","72","940.31666666667","7","25","15","10","32","76.19"
"29","Brad Marchand","BOS","L","73","924.3","10","22","16","6","32","68.09"
"152","Kevin Hayes","PHI","C","81","1131.0666666667","10","22","19","3","32","71.11"
"168","Nino Niederreiter","NSH, WPG","R","78","1011.7666666667","19","13","6","7","32","69.57"
"194","Blake Coleman","CGY","C","82","1104.0833333333","12","20","12","8","32","72.73"
"211","Ryan Strome","ANA","C","82","1132.3833333333","10","22","10","12","32","68.09"
"375","Dylan Larkin","DET","C","80","1034.5333333333","9","23","16","7","32","69.57"
"408","Gustav Forsling","FLA","D","82","1487.6","12","20","14","6","32","40.51"
"455","Travis Konecny","PHI","R","60","850.38333333333","17","15","11","4","32","86.49"
"472","Daniel Sprong","SEA","R","66","618.81666666667","15","17","14","3","32","80.00"
"810","Kaapo Kakko","NYR","R","82","1111.15","15","17","11","6","32","61.54"
"7","Patrice Bergeron","BOS","C","78","882.36666666667","14","17","8","9","31","67.39"
"38","Jordan Staal","CAR","C","81","1044.25","15","16","6","10","31","68.89"
"71","Alex Pietrangelo","VGK","D","73","1297.6","7","24","10","14","31","49.21"
"79","Roman Josi","NSH","D","67","1289","8","23","15","8","31","49.21"
"130","Anders Lee","NYI","L","82","1100.2333333333","20","11","7","4","31","57.41"
"143","Evgeny Kuznetsov","WSH","C","81","1043.8666666667","6","25","17","8","31","67.39"
"154","Vladimir Tarasenko","NYR, STL","R","69","940.71666666667","12","19","10","9","31","67.39"
"164","Tyler Seguin","DAL","C","76","955.78333333333","10","21","10","11","31","75.61"
"217","J.T. Miller","VAN","C","81","1108.75","11","20","14","6","31","77.50"
"265","Jordan Martinook","CAR","L","82","1085.35","11","20","14","6","31","60.78"
"340","Darnell Nurse","EDM","D","82","1524.1833333333","7","24","12","12","31","42.47"
"344","Max Domi","CHI, DAL","C","80","1123.2833333333","7","24","17","7","31","67.39"
"500","Conor Garland","VAN","R","81","1045.4","12","19","9","10","31","77.50"
"713","Quinn Hughes","VAN","D","78","1469.2","4","27","13","14","31","38.27"
"720","K'Andre Miller","NYR","D","79","1465.3","7","24","9","15","31","46.27"
"5","Brent Burns","CAR","D","82","1390.9833333333","12","18","13","5","30","46.88"
"138","Mats Zuccarello","MIN","R","78","1170.6","9","21","18","3","30","69.77"
"322","J.T. Compher","COL","L","82","1188.5833333333","12","18","11","7","30","60.00"
"459","Mathew Barzal","NYI","C","58","819.2","9","21","16","5","30","76.92"
"482","Jake DeBrusk","BOS","L","64","757.25","19","11","8","3","30","63.83"
"534","Alex DeBrincat","OTT","R","82","1138","12","18","14","4","30","71.43"
"536","Patrik Laine","CBJ","L","55","803.8","13","17","10","7","30","83.33"
"567","Pierre-Luc Dubois","WPG","L","73","1011.0166666667","12","18","8","10","30","61.22"
"650","Miro Heiskanen","DAL","D","79","1523.6333333333","5","25","12","13","30","41.10"
"846","Matias Maccelli","ARI","L","64","812.81666666667","8","22","13","9","30","83.33"
"867","Jack Quinn","BUF","R","75","852.36666666667","13","17","9","8","30","65.22"
"139","Calle Jarnkrok","TOR","C","73","812.4","16","13","6","7","29","72.50"
"366","Sam Reinhart","FLA","C","82","1074.65","9","20","12","8","29","74.36"
"415","Kevin Labanc","S.J","R","72","901.43333333333","13","16","12","4","29","61.70"
"467","Jack Roslovic","CBJ","C","77","931.3","6","23","15","8","29","72.50"
"470","Anthony Beauvillier","NYI, VAN","L","82","1102.3","12","17","10","7","29","59.18"
"548","Trent Frederic","BOS","C","79","884.71666666667","16","13","6","7","29","61.70"
"638","Gabriel Vilardi","L.A","C, R","63","766.76666666667","17","12","7","5","29","87.88"
"679","Drake Batherson","OTT","R","82","1142.7666666667","7","22","15","7","29","67.44"
"725","Jesperi Kotkaniemi","CAR","C","82","1020.5833333333","12","17","5","12","29","67.44"
"870","Alexis Lafrenière","NYR","L","81","1083.6666666667","12","17","8","9","29","58.00"
"55","David Perron","DET","L","82","1035.1","15","13","11","2","28","56.00"
"113","Chris Kreider","NYR","L","79","996.15","19","9","6","3","28","58.33"
"131","Nick Jensen","WSH","D","77","1351.8666666667","5","23","14","9","28","54.90"
"169","Bryan Rust","PIT","R","81","1082.1833333333","14","14","7","7","28","54.90"
"210","Adam Larsson","SEA","D","82","1607.15","6","22","12","10","28","32.18"
"222","Phillip Danault","L.A","C","82","1104.1833333333","13","15","9","6","28","71.79"
"235","Hampus Lindholm","BOS","D","80","1381.6333333333","6","22","12","10","28","36.84"
"318","Shea Theodore","VGK","D","55","983.51666666667","5","23","9","14","28","53.85"
"660","Cale Makar","COL","D","60","1087.8833333333","9","19","9","10","28","50.91"
"791","Blake Lizotte","L.A","C","81","910.96666666667","10","18","14","4","28","65.12"
"811","Matt Boldy","MIN","L","81","1075.9333333333","20","8","3","5","28","70.00"
"97","Kyle Palmieri","NYI","C","55","748.03333333333","13","14","11","3","27","61.36"
"129","Erik Haula","N.J","L","80","1038.0666666667","10","17","10","7","27","54.00"
"192","Nick Cousins","FLA","C","79","844.83333333333","9","18","8","10","27","69.23"
"227","Barclay Goodrow","NYR","C","82","955.4","10","17","9","8","27","69.23"
"239","Brady Skjei","CAR","D","81","1433.6666666667","11","16","6","10","27","45.00"
"266","Damon Severson","N.J","D","81","1365.2166666667","4","23","11","12","27","45.00"
"275","Andreas Athanasiou","CHI","C","81","1090.7666666667","14","13","8","5","27","71.05"
"320","Ryan Hartman","MIN","R","59","794.65","11","16","10","6","27","77.14"
"329","Artturi Lehkonen","COL","L","64","927.71666666667","10","17","8","9","27","56.25"
"368","Sam Bennett","FLA","C","63","825.33333333333","9","18","11","7","27","61.36"
"376","Sonny Milano","WSH","L","64","763.65","10","17","8","9","27","67.50"
"396","Warren Foegele","EDM","L","67","776.01666666667","12","15","10","5","27","77.14"
"403","Viktor Arvidsson","L.A","L, R","77","1072.4166666667","12","15","12","3","27","65.85"
"429","Frank Vatrano","ANA","R","81","1088.9833333333","13","14","9","5","27","71.05"
"454","Tommy Novak","NSH","C","51","581.21666666667","11","16","11","5","27","81.82"
"623","Morgan Geekie","SEA","C","69","655.71666666667","8","19","11","8","27","65.85"
"886","JJ Peterka","BUF","R","77","924.71666666667","10","17","12","5","27","61.36"
"1","Eric Staal","FLA","C","72","816.86666666667","12","14","8","6","26","78.79"
"103","Victor Hedman","T.B","D","76","1373.8333333333","6","20","10","10","26","41.94"
"150","Nick Bjugstad","ARI, EDM","C","78","1006.9166666667","15","11","6","5","26","60.47"
"153","Cam Fowler","ANA","D","82","1509.2","6","20","10","10","26","47.27"
"200","Boone Jenner","CBJ","C","68","1050.6","15","11","7","4","26","61.90"
"201","Brandon Saad","STL","L","71","933.48333333333","12","14","11","3","26","63.41"
"252","Filip Forsberg","NSH","L","50","651.11666666667","14","12","8","4","26","72.22"
"295","MacKenzie Weegar","CGY","D","81","1430.7333333333","4","22","8","14","26","41.94"
"313","Andrew Copp","DET","C","82","1062.2166666667","5","21","14","7","26","65.00"
"356","Conor Sheary","WSH","L","82","1029.2666666667","11","15","11","4","26","54.17"
"517","Brandon Tanev","SEA","L","82","917.81666666667","10","16","10","6","26","65.00"
"528","Charlie McAvoy","BOS","D","67","1093.2333333333","3","23","13","10","26","43.33"
"737","Barrett Hayton","ARI","C","82","1075.4333333333","12","14","8","6","26","50.98"
"742","Noah Dobson","NYI","D","78","1211.5666666667","7","19","12","7","26","42.62"
"836","Alex Newhook","COL","C","82","999.35","11","15","8","7","26","60.47"
"40","Phil Kessel","VGK","C, R","82","917.28333333333","12","13","5","8","25","64.10"
"86","Adam Henrique","ANA","C","62","772.83333333333","15","10","4","6","25","71.43"
"162","Taylor Hall","BOS","L","61","788.63333333333","9","16","10","6","25","65.79"
"173","Jesper Fast","CAR","R","80","1025.5166666667","10","15","5","10","25","59.52"
"278","Josh Anderson","MTL","R","69","918.85","15","10","7","3","25","53.19"
"330","William Carrier","VGK","L","56","660.38333333333","16","9","8","1","25","78.13"
"346","Alex Wennberg","SEA","C","82","1093.3333333333","7","18","11","7","25","58.14"
"371","Nikolaj Ehlers","WPG","L","45","549.55","9","16","12","4","25","92.59"
"393","Ryan Donato","SEA","C","71","751.83333333333","14","11","8","3","25","59.52"
"400","Michael Amadio","VGK","C, R","67","774.06666666667","15","10","8","2","25","64.10"
"418","Pierre Engvall","NYI, TOR","L","76","909.95","15","10","7","3","25","55.56"
"566","Samuel Girard","COL","D","76","1387.9","4","21","7","14","25","45.45"
"681","Noah Cates","PHI","L","82","1094.1666666667","8","17","9","8","25","59.52"
"716","Evan Bouchard","EDM","D","82","1234.7666666667","5","20","7","13","25","37.88"
"837","Ilya Mikheyev","VAN","R","46","619.63333333333","12","13","8","5","25","62.50"
"865","Seth Jarvis","CAR","C","82","1090.0833333333","13","12","6","6","25","55.56"
"176","Mark Stone","VGK","R","43","620.35","11","13","8","5","24","68.57"
"267","Colton Sissons","NSH","C","82","972.28333333333","9","15","4","11","24","68.57"
"277","Erik Gustafsson","TOR, WSH","D","70","1143.9","7","17","9","8","24","44.44"
"283","Alexander Kerfoot","TOR","C","82","971.93333333333","6","18","10","8","24","58.54"
"292","Dominik Kubalik","DET","L","81","957.71666666667","12","12","9","3","24","55.81"
"311","Miles Wood","N.J","L","76","819.96666666667","11","13","9","4","24","75.00"
"343","Valeri Nichushkin","COL","R","53","734.91666666667","5","19","10","9","24","63.16"
"382","Kasperi Kapanen","PIT, STL","R","66","737.65","8","16","12","4","24","77.42"
"416","Sammy Blais","NYR, STL","L","71","767.4","9","15","6","9","24","72.73"
"432","Noah Hanifin","CGY","D","81","1406.8333333333","5","19","10","9","24","35.29"
"433","Rasmus Andersson","CGY","D","79","1393.05","8","16","11","5","24","35.29"
"490","Evan Rodrigues","COL","C","69","1021.45","8","16","9","7","24","47.06"
"573","Michael McLeod","N.J","C","80","860.78333333333","3","21","11","10","24","70.59"
"667","Alex Iafallo","L.A","L","59","725.23333333333","6","18","10","8","24","75.00"
"669","Neal Pionk","WPG","D","82","1419.4833333333","6","18","7","11","24","42.11"
"736","Ty Dellandrea","DAL","C","82","976.08333333333","8","16","9","7","24","57.14"
"790","Nico Sturm","S.J","C","74","852.51666666667","12","12","7","5","24","64.86"
"804","Cole Caufield","MTL","R","46","632.65","17","7","2","5","24","64.86"
"913","Kent Johnson","CBJ","C","79","964.3","9","15","11","4","24","61.54"
"916","Owen Power","BUF","D","79","1560.3833333333","3","21","8","13","24","27.27"
"927","Mason McTavish","ANA","C","80","999.18333333333","8","16","12","4","24","72.73"
"92","Jared Spurgeon","MIN","D","79","1274.6166666667","9","14","7","7","23","40.35"
"96","Marcus Johansson","MIN, WSH","L","80","972.45","11","12","8","4","23","51.11"
"120","Mattias Ekholm","EDM, NSH","D","78","1304.2333333333","8","15","10","5","23","36.51"
"132","Nic Dowd","WSH","C","65","692.23333333333","13","10","7","3","23","74.19"
"156","Jaden Schwartz","SEA","C","71","997.88333333333","9","14","8","6","23","65.71"
"191","Adam Lowry","WPG","C","82","932.61666666667","9","14","7","7","23","69.70"
"312","Nicholas Paul","T.B","L","80","1041.1333333333","9","14","7","7","23","53.49"
"417","Victor Olofsson","BUF","L","75","847.28333333333","17","6","5","1","23","67.65"
"512","Mason Marchment","DAL","L","68","923.5","8","15","9","6","23","74.19"
"586","Ross Colton","T.B","C","81","889.33333333333","12","11","8","3","23","71.88"
"668","David Kampf","TOR","C","82","997.93333333333","7","16","7","9","23","62.16"
"739","Jack McBain","ARI","C","82","927.35","10","13","8","5","23","74.19"
"745","Rasmus Sandin","TOR, WSH","D","71","1157.8666666667","7","16","6","10","23","38.33"
"773","Yegor Sharangovich","N.J","C","75","897.88333333333","9","14","8","6","23","63.89"
"784","Logan O'Connor","COL","R","82","985.21666666667","7","16","11","5","23","60.53"
"826","Shane Pinto","OTT","C","82","1055.6666666667","14","9","4","5","23","63.89"
"883","Cole Perfetti","WPG","C","51","662.75","5","18","8","10","23","79.31"
"21","T.J. Oshie","WSH","R","58","723.9","10","12","5","7","22","75.86"
"58","Evgenii Dadonov","DAL, MTL","R","73","908.41666666667","7","15","8","7","22","57.89"
"185","Dylan DeMelo","WPG","D","75","1230.2666666667","3","19","9","10","22","41.51"
"197","Jean-Gabriel Pageau","NYI","C","70","861.36666666667","3","19","11","8","22","62.86"
"199","Scott Mayfield","NYI","D","82","1442.2333333333","6","16","7","9","22","43.14"
"204","Matt Nieto","COL, S.J","L","81","897.68333333333","11","11","4","7","22","56.41"
"216","Jamie Oleksiak","SEA","D","75","1193.75","7","15","6","9","22","37.93"
"241","Scott Laughton","PHI","C","78","1056.1","8","14","6","8","22","52.38"
"243","Olli Maatta","DET","D","78","1282.7166666667","5","17","8","9","22","53.66"
"254","Matt Grzelcyk","BOS","D","75","1186.4833333333","3","19","8","11","22","31.43"
"316","Andre Burakovsky","SEA","L","49","656.25","8","14","10","4","22","73.33"
"350","Anthony Mantha","WSH","R","67","854.41666666667","10","12","8","4","22","62.86"
"362","Frederick Gaudreau","MIN","C","82","980.78333333333","9","13","8","5","22","61.11"
"553","Tyson Jost","BUF, MIN","C","71","826.2","5","17","8","9","22","68.75"
"635","Eeli Tolvanen","NSH, SEA","R","61","722.05","14","8","5","3","22","53.66"
"4","Zach Parise","NYI","L","82","1007.1","12","9","6","3","21","60.00"
"9","Mark Giordano","TOR","D","78","1211.1666666667","2","19","8","11","21","37.50"
"30","Nick Foligno","BOS","L","60","637.45","8","13","10","3","21","63.64"
"50","James van Riemsdyk","PHI","L","61","772.25","8","13","7","6","21","61.76"
"74","Josh Bailey","NYI","R","64","774.18333333333","8","13","8","5","21","60.00"
"98","Ryan O'Reilly","STL, TOR","C","53","728.55","11","10","5","5","21","63.64"
"105","Evander Kane","EDM","L","41","641.93333333333","14","7","3","4","21","80.77"
"117","Tyson Barrie","EDM, NSH","D","85","1309.9833333333","8","13","8","5","21","41.18"
"118","Dmitry Orlov","BOS, WSH","D","66","1178.3","4","17","5","12","21","43.75"
"167","Mikael Granlund","NSH, PIT","C","79","1011.0166666667","6","15","8","7","21","58.33"
"184","Travis Boyd","ARI","C","82","1036.0833333333","12","9","5","4","21","53.85"
"223","Vladislav Namestnikov","T.B, WPG","C","77","824.15","7","14","5","9","21","61.76"
"244","Mike Matheson","MTL","D","48","858.26666666667","6","15","10","5","21","58.33"
"251","Jacob Trouba","NYR","D","82","1418.7333333333","5","16","8","8","21","31.82"
"255","Colton Parayko","STL","D","79","1554.75","4","17","5","12","21","42.00"
"269","Jake McCabe","CHI, TOR","D","76","1275.35","3","18","9","9","21","34.43"
"274","Jaccob Slavin","CAR","D","76","1368.75","4","17","8","9","21","35.59"
"279","Matthew Benning","S.J","D","77","1205.5833333333","1","20","11","9","21","45.65"
"315","Ryan Graves","N.J","D","78","1326.8833333333","8","13","4","9","21","30.00"
"347","Ryan Pulock","NYI","D","82","1438.35","4","17","8","9","21","31.34"
"361","Garnet Hathaway","BOS, WSH","R","84","851.23333333333","13","8","3","5","21","63.64"
"388","Marcus Pettersson","PIT","D","68","1225.2333333333","1","20","13","7","21","37.50"
"452","Christian Fischer","ARI","R","80","948.38333333333","11","10","7","3","21","70.00"
"489","Anthony Cirelli","T.B","C","58","740.9","7","14","10","4","21","60.00"
"539","Jakob Chychrun","ARI, OTT","D","48","857.11666666667","4","17","5","12","21","46.67"
"543","Sam Steel","MIN","C","65","828.06666666667","8","13","5","8","21","56.76"
"616","Kailer Yamamoto","EDM","R","58","821.9","9","12","5","7","21","52.50"
"625","Michael Rasmussen","DET","C","56","676.4","7","14","9","5","21","67.74"
"632","Jesper Boqvist","N.J","C","70","758.43333333333","10","11","4","7","21","63.64"
"795","Peyton Krebs","BUF","C","74","873.88333333333","7","14","7","7","21","70.00"
"806","Moritz Seider","DET","D","82","1326.4166666667","3","18","9","9","21","38.18"
"2","Ryan Suter","DAL","D","82","1363.85","3","17","7","10","20","36.36"
"73","Luke Schenn","TOR, VAN","D","70","1013.9","4","16","10","6","20","40.82"
"88","Gustav Nyquist","CBJ, MIN","C, L","51","677.16666666667","8","12","7","5","20","74.07"
"95","Mike Hoffman","MTL","L","67","834.58333333333","11","9","5","4","20","64.52"
"112","Nick Leddy","STL","D","78","1448.0333333333","2","18","10","8","20","30.77"
"221","Stefan Noesen","CAR","R","78","735","5","15","8","7","20","64.52"
"249","Teuvo Teravainen","CAR","L","68","824.26666666667","4","16","12","4","20","54.05"
"299","Connor Clifton","BOS","D","78","1235.35","4","16","8","8","20","34.48"
"319","Jason Dickinson","CHI","C","78","1003.0666666667","8","12","7","5","20","62.50"
"333","Brett Pesce","CAR","D","82","1449.25","2","18","11","7","20","30.77"
"337","Seth Jones","CHI","D","72","1309.1333333333","8","12","6","6","20","40.00"
"357","Trevor van Riemsdyk","WSH","D","75","1172.2833333333","7","13","5","8","20","32.79"
"404","Sam Lafferty","CHI, TOR","C","70","829.75","8","12","7","5","20","76.92"
"405","Danton Heinen","PIT","L","65","642.25","7","13","8","5","20","80.00"
"409","Dakota Joshua","VAN","C","79","811.73333333333","9","11","5","6","20","83.33"
"497","Denis Malgin","COL, TOR","C","65","661.36666666667","13","7","5","2","20","80.00"
"514","Ryan Lomberg","FLA","L","82","882.03333333333","12","8","5","3","20","52.63"
"563","Taylor Raddysh","CHI","R","78","1014.2","12","8","3","5","20","64.52"
"627","Cody Glass","NSH","C","72","842.98333333333","6","14","7","7","20","58.82"
"675","Fabian Zetterlund","N.J, S.J","L","67","816.83333333333","5","15","11","4","20","62.50"
"686","Nick Perbix","T.B","D","69","1010.9166666667","5","15","10","5","20","40.82"
"697","Sean Durzi","L.A","D","72","1105.0666666667","8","12","5","7","20","43.48"
"702","Pius Suter","DET","C","79","937.36666666667","12","8","5","3","20","64.52"
"707","Eric Robinson","CBJ","L","72","825.6","10","10","4","6","20","90.91"
"715","Ryan McLeod","EDM","C","57","645.16666666667","9","11","8","3","20","74.07"
"767","Alexander Romanov","NYI","D","76","1288.8","2","18","9","9","20","37.74"
"859","Lucas Raymond","DET","L","74","971.48333333333","10","10","5","5","20","60.61"
"32","Kyle Okposo","BUF","R","75","926.26666666667","6","13","7","6","19","67.86"
"36","Jeff Petry","PIT","D","61","1031.7333333333","3","16","5","11","19","37.25"
"69","Drew Doughty","L.A","D","81","1566.5","4","15","3","12","19","32.20"
"119","Brian Dumoulin","PIT","D","82","1401.9833333333","1","18","12","6","19","36.54"
"175","John Klingberg","ANA, MIN","D","67","1127.5333333333","6","13","10","3","19","43.18"
"234","Morgan Rielly","TOR","D","65","1083.6166666667","3","16","11","5","19","41.30"
"259","Shayne Gostisbehere","ARI, CAR","D","75","1231.9166666667","4","15","7","8","19","36.54"
"263","Jimmy Vesey","NYR","L","81","956.25","7","12","6","6","19","46.34"
"307","Mattias Janmark","EDM","C","66","814.36666666667","5","14","9","5","19","63.33"
"331","Tyler Bertuzzi","BOS, DET","L","50","653","4","15","10","5","19","57.58"
"348","Nikita Zadorov","CGY","D","82","1295.2833333333","13","6","4","2","19","30.16"
"379","Tony DeAngelo","PHI","D","70","1172.3","5","14","9","5","19","39.58"
"394","Christian Dvorak","MTL","C","64","780.8","6","13","3","10","19","76.00"
"435","Jonas Siegenthaler","N.J","D","80","1382.8833333333","3","16","7","9","19","24.36"
"469","Nicolas Roy","VGK","C","65","825.93333333333","9","10","7","3","19","59.38"
"495","Will Borgen","SEA","D","82","1188.7333333333","3","16","9","7","19","32.20"
"551","Max Jones","ANA","L","69","836.68333333333","9","10","4","6","19","82.61"
"636","Klim Kostin","EDM","C","57","563.85","11","8","6","2","19","67.86"
"682","Sebastian Aho","NYI","D","71","1064.5","4","15","6","9","19","38.78"
"712","Philipp Kurashev","CHI","C","70","966.5","8","11","8","3","19","48.72"
"873","Anton Lundell","FLA","C","73","872.21666666667","9","10","5","5","19","48.72"
"877","Quinton Byfield","L.A","C","53","657.1","1","18","10","8","19","51.35"
"16","Paul Stastny","CAR","C","73","738.28333333333","7","11","5","6","18","62.07"
"48","Kevin Shattenkirk","ANA","D","75","1179.95","3","15","7","8","18","37.50"
"65","Lars Eller","COL, WSH","C","84","1051.15","8","10","7","3","18","51.43"
"91","Matt Martin","NYI","L","81","881.48333333333","7","11","7","4","18","64.29"
"133","Brenden Dillon","WPG","D","82","1347.0166666667","2","16","9","7","18","39.13"
"180","Ondrej Palat","N.J","L","49","658.48333333333","7","11","8","3","18","58.06"
"225","Colin Miller","DAL","D","79","1237.8166666667","5","13","7","6","18","29.51"
"253","Radek Faksa","DAL","C","81","918.1","10","8","5","3","18","69.23"
"256","Oskar Sundqvist","DET, MIN","C","67","723.55","6","12","5","7","18","64.29"
"257","Esa Lindell","DAL","D","82","1280.6166666667","5","13","6","7","18","33.33"
"303","Hudson Fasching","NYI","R","49","598.2","10","8","6","2","18","54.55"
"336","Jonathan Drouin","MTL","L","58","700.48333333333","2","16","9","7","18","78.26"
"377","Travis Sanheim","PHI","D","81","1391.5666666667","6","12","9","3","18","39.13"
"453","Keegan Kolesar","VGK","R","74","835.51666666667","8","10","10","0","18","58.06"
"483","Ivan Provorov","PHI","D","82","1508.3833333333","5","13","5","8","18","32.14"
"487","Yakov Trenin","NSH","C","77","942.81666666667","9","9","6","3","18","78.26"
"509","Matt Roy","L.A","D","82","1292.2666666667","5","13","5","8","18","30.00"
"533","Carl Grundstrom","L.A","R","57","568.75","11","7","5","2","18","72.00"
"657","Pierre-Olivier Joseph","PIT","D","75","1040.0166666667","4","14","7","7","18","33.96"
"670","Calle Rosen","STL","D","49","697.6","8","10","4","6","18","40.91"
"766","Jonatan Berggren","DET","R","67","773.1","9","9","5","4","18","64.29"
"769","Paul Cotter","VGK","C","55","679.01666666667","13","5","2","3","18","69.23"
"796","Kirby Dach","MTL","C","58","802.18333333333","8","10","6","4","18","48.65"
"912","J.J. Moser","ARI","D","82","1241.9833333333","3","15","7","8","18","37.50"
"22","Andrew Cogliano","COL","C","79","829.73333333333","10","7","3","4","17","56.67"
"33","Trevor Lewis","CGY","C","82","825.03333333333","6","11","7","4","17","62.96"
"34","Milan Lucic","CGY","L","77","841.51666666667","7","10","8","2","17","54.84"
"80","Justin Schultz","SEA","D","73","1090.05","5","12","4","8","17","34.69"
"94","Tyler Johnson","CHI","C","56","739.5","6","11","6","5","17","70.83"
"121","Marcus Foligno","MIN","L","65","802.75","7","10","6","4","17","65.38"
"125","David Savard","MTL","D","62","1119.0333333333","3","14","5","9","17","45.95"
"128","Ben Chiarot","DET","D","76","1286","3","14","7","7","17","36.96"
"135","Radko Gudas","FLA","D","72","1023.65","2","15","7","8","17","36.17"
"140","Justin Holl","TOR","D","80","1329.5","2","15","2","13","17","27.87"
"296","Tyler Motte","NYR, OTT","C, L","62","626.18333333333","6","11","7","4","17","77.27"
"492","Noel Acciari","STL, TOR","C","77","941.06666666667","10","7","3","4","17","68.00"
"493","Derek Ryan","EDM","C","80","774.03333333333","11","6","3","3","17","54.84"
"606","Trevor Moore","L.A","C, L","59","771.38333333333","6","11","8","3","17","70.83"
"615","Juuso Valimaki","ARI","D","78","1170.7666666667","2","15","6","9","17","32.08"
"628","Mikey Anderson","L.A","D","77","1433.8166666667","4","13","2","11","17","29.31"
"646","Max Comtois","ANA","L","64","794.65","9","8","5","3","17","56.67"
"690","Alexey Toropchenko","STL","R","69","738.96666666667","8","9","5","4","17","60.71"
"23","Marc-Edouard Vlasic","S.J","D","78","1121.7333333333","1","15","3","12","16","35.56"
"24","Kris Letang","PIT","D","64","1226.4833333333","4","12","3","9","16","30.77"
"45","Nick Bonino","PIT, S.J","C","62","716.66666666667","9","7","6","1","16","51.61"
"60","Ryan McDonagh","NSH","D","71","1234.2","2","14","8","6","16","29.09"
"82","Travis Hamonic","OTT","D","75","1110.8666666667","5","11","5","6","16","33.33"
"124","Casey Cizikas","NYI","C","81","972.16666666667","5","11","7","4","16","57.14"
"147","Tyler Pitlick","STL","C","61","594.98333333333","7","9","7","2","16","69.57"
"196","Josh Leivo","STL","L","51","566.98333333333","4","12","9","3","16","59.26"
"262","Adam Pelech","NYI","D","61","1105.2833333333","5","11","6","5","16","34.78"
"276","Brett Kulak","EDM","D","82","1251.7333333333","3","13","2","11","16","28.57"
"372","Nick Ritchie","ARI, CGY","L","74","817.53333333333","9","7","5","2","16","55.17"
"508","Steven Lorentz","S.J","C","80","802.05","8","8","2","6","16","72.73"
"555","Josh Mahura","FLA","D","82","1082.2333333333","4","12","8","4","16","32.00"
"564","Noah Gregor","S.J","C","57","692.5","10","6","5","1","16","64.00"
"577","Filip Hronek","DET, VAN","D","64","1061.7833333333","4","12","4","8","16","34.04"
"604","Tanner Jeannot","NSH, T.B","L","76","881.61666666667","5","11","5","6","16","55.17"
"617","Nicolas Hague","VGK","D","81","1377.6833333333","2","14","9","5","16","27.59"
"752","Jordan Harris","MTL","D","65","1096.7666666667","4","12","5","7","16","34.04"
"755","Kirill Marchenko","CBJ","R","59","763.1","13","3","3","0","16","64.00"
"857","Braden Schneider","NYR","D","81","1188.2333333333","5","11","5","6","16","32.65"
"862","Kaiden Guhle","MTL","D","44","744.13333333333","4","12","9","3","16","53.33"
"3","Jeff Carter","PIT","C","79","833.63333333333","7","8","3","5","15","62.50"
"26","Ryan Reaves","MIN, NYR","R","73","671.25","5","10","5","5","15","71.43"
"101","Jakob Silfverberg","ANA","R","81","855.6","6","9","6","3","15","57.69"
"107","Oliver Ekman-Larsson","VAN","D","54","908.6","2","13","9","4","15","40.54"
"111","Dmitry Kulikov","ANA, PIT","D","67","1068","3","12","8","4","15","37.50"
"122","Craig Smith","BOS, WSH","C","64","673.68333333333","9","6","1","5","15","51.72"
"163","Ryan Johansen","NSH","C","55","633.13333333333","6","9","5","4","15","68.18"
"229","Torey Krug","STL","D","63","949.75","3","12","6","6","15","36.59"
"300","Carson Soucy","SEA","D","78","1105.9","3","12","4","8","15","28.85"
"365","Aaron Ekblad","FLA","D","71","1149.7166666667","4","11","8","3","15","28.85"
"538","Jesse Puljujarvi","CAR, EDM","R","75","854.1","5","10","6","4","15","53.57"
"676","Johnathan Kovacevic","MTL","D","77","1165.7","3","12","6","6","15","28.85"
"678","Emil Bemstrom","CBJ","R","55","586.95","3","12","7","5","15","65.22"
"691","Morgan Barron","WPG","C","70","790","6","9","5","4","15","62.50"
"719","Joe Veleno","DET","C","81","935.21666666667","8","7","4","3","15","50.00"
"813","Arthur Kaliyev","L.A","R","56","527.3","5","10","4","6","15","60.00"
"840","Aliaksei Protas","WSH","C","58","641.66666666667","4","11","5","6","15","65.22"
"844","Juuso Parssinen","NSH","C","45","540.38333333333","3","12","6","6","15","65.22"
"20","Marc Staal","FLA","D","82","1239.15","3","11","4","7","14","22.58"
"42","Jonathan Toews","CHI","C","53","685.8","4","10","6","4","14","70.00"
"46","Ian Cole","T.B","D","78","1242.7833333333","3","11","7","4","14","26.92"
"89","Derek Grant","ANA","C","46","510.96666666667","3","11","7","4","14","73.68"
"170","Jani Hakanpää","DAL","D","82","1274.7166666667","5","9","4","5","14","27.45"
"177","Alex Belzile","MTL","R","31","337.61666666667","6","8","3","5","14","73.68"
"236","Matt Dumba","MIN","D","79","1453.85","4","10","6","4","14","31.11"
"245","Zemgus Girgensons","BUF","L","80","894.6","9","5","1","4","14","66.67"
"270","Brock McGinn","ANA, PIT","L","75","791.35","9","5","2","3","14","60.87"
"321","Adam Erne","DET","L","61","699.86666666667","6","8","4","4","14","70.00"
"364","Tomas Nosek","BOS","L","66","639.76666666667","4","10","5","5","14","70.00"
"398","Jake Walman","DET","D","63","1007.55","8","6","2","4","14","32.56"
"412","Oskar Lindblom","S.J","L","73","679.45","6","8","3","5","14","60.87"
"421","Jake Middleton","MIN","D","79","1284.2","3","11","5","6","14","30.43"
"436","Colin White","FLA","C","68","607.33333333333","7","7","5","2","14","58.33"
"451","Evgeny Svechnikov","S.J","L","59","604.53333333333","8","6","5","1","14","53.85"
"474","Thomas Chabot","OTT","D","68","1335.2166666667","4","10","4","6","14","21.54"
"481","Denis Gurianov","DAL, MTL","R","66","769.56666666667","6","8","7","1","14","60.87"
"525","Wade Allison","PHI","R","60","748.85","9","5","1","4","14","60.87"
"527","Ryan Lindgren","NYR","D","63","1020.6666666667","0","14","9","5","14","28.57"
"529","Julien Gauthier","NYR, OTT","R","57","483.9","9","5","3","2","14","73.68"
"560","Boris Katchouk","CHI","L","58","606.7","5","9","6","3","14","77.78"
"572","Nathan Bastian","N.J","R","43","429.56666666667","6","8","4","4","14","87.50"
"579","Troy Stecher","ARI, CGY","D","81","1120.1","3","11","7","4","14","42.42"
"591","Michael Pezzetta","MTL","L","63","553.15","7","7","7","0","14","53.85"
"599","Michael Eyssimont","S.J, T.B, WPG","C","54","613.15","5","9","4","5","14","50.00"
"611","Zach Aston-Reese","TOR","C","77","764.4","10","4","2","2","14","66.67"
"614","Mason Shaw","MIN","C","59","563.93333333333","6","8","3","5","14","87.50"
"634","Adam Ruzicka","CGY","C","44","429.55","4","10","6","4","14","77.78"
"709","Oliver Wahlstrom","NYI","R","35","381.18333333333","6","8","2","6","14","70.00"
"710","Martin Fehervary","WSH","D","67","1180.8","4","10","5","5","14","31.11"
"734","Rasmus Kupari","L.A","C","66","584.66666666667","3","11","7","4","14","63.64"
"738","Liam Foudy","CBJ","C","62","670.8","7","7","6","1","14","73.68"
"772","Jesse Ylonen","MTL","R","37","445.01666666667","5","9","3","6","14","93.33"
"808","Cam York","PHI","D","54","900.55","2","12","7","5","14","36.84"
"869","Jake Sanderson","OTT","D","77","1174.35","2","12","7","5","14","30.43"
"903","Nils Aman","VAN","C","68","760.91666666667","4","10","5","5","14","70.00"
"39","Derick Brassard","OTT","C","62","612.08333333333","8","5","4","1","13","54.17"
"49","Pat Maroon","T.B","L","80","814.95","5","8","4","4","13","59.09"
"67","Nick Holden","OTT","D","65","884.68333333333","2","11","5","6","13","41.94"
"87","TJ Brodie","TOR","D","58","1015.7333333333","2","11","3","8","13","29.55"
"187","Nick Seeler","PHI","D","77","1030.2","4","9","6","3","13","31.71"
"188","Sean Kuraly","CBJ","C","71","870.46666666667","6","7","5","2","13","56.52"
"268","Teddy Blueger","PIT, VGK","C","63","662.46666666667","3","10","8","2","13","68.42"
"289","Nate Schmidt","WPG","D","71","1069.4166666667","4","9","4","5","13","36.11"
"420","Jake Evans","MTL","C","54","607.13333333333","0","13","11","2","13","68.42"
"457","Brandon Carlo","BOS","D","75","1130.25","2","11","6","5","13","22.03"
"486","John Marino","N.J","D","64","1084.1666666667","1","12","10","2","13","29.55"
"506","Vladislav Gavrikov","CBJ, L.A","D","72","1262.3333333333","3","10","6","4","13","29.55"
"589","Axel Jonsson-Fjallby","WPG","L","50","470.13333333333","6","7","3","4","13","81.25"
"605","Mathieu Olivier","CBJ","R","66","720.6","5","8","6","2","13","61.90"
"612","Gavin Bayreuther","CBJ","D","51","741.03333333333","2","11","4","7","13","52.00"
"649","Henri Jokiharju","BUF","D","60","1095.0833333333","3","10","3","7","13","24.07"
"654","Timothy Liljegren","TOR","D","67","1026.9","5","8","4","4","13","26.00"
"664","Erik Brannstrom","OTT","D","74","985.83333333333","2","11","5","6","13","33.33"
"744","Adam Boqvist","CBJ","D","46","677.91666666667","5","8","4","4","13","39.39"
"762","Connor Dewar","MIN","C","81","736.61666666667","3","10","5","5","13","76.47"
"777","Rafael Harvey-Pinard","MTL","L","34","453.2","8","5","3","2","13","48.15"
"797","Bowen Byram","COL","D","42","790.56666666667","5","8","6","2","13","39.39"
"6","Corey Perry","T.B","R","81","762.4","6","6","4","2","12","52.17"
"75","Tyler Myers","VAN","D","78","1399.1166666667","1","11","6","5","12","21.43"
"109","Calvin de Haan","CAR","D","53","682.03333333333","2","10","4","6","12","40.00"
"114","Brayden McNabb","VGK","D","82","1408.4","1","11","6","5","12","20.00"
"172","Brendan Gallagher","MTL","R","37","442.45","8","4","4","0","12","63.16"
"202","Brett Ritchie","ARI, CGY","R","50","488.51666666667","8","4","1","3","12","66.67"
"246","Cody Ceci","EDM","D","80","1318.6666666667","1","11","4","7","12","21.82"
"390","Nicolas Aube-Kubel","TOR, WSH","R","53","587.06666666667","4","8","3","5","12","57.14"
"446","Erik Cernak","T.B","D","70","1088.9166666667","1","11","5","6","12","26.09"
"463","Ethan Bear","VAN","D","61","979.06666666667","2","10","5","5","12","29.27"
"475","Mathieu Joseph","OTT","R","56","594.8","0","12","8","4","12","46.15"
"507","Mason Appleton","WPG","C","41","538.85","3","9","4","5","12","57.14"
"511","Jalen Chatfield","CAR","D","78","1019.8","5","7","4","3","12","24.49"
"544","Brett Howden","VGK","C","54","654.46666666667","5","7","4","3","12","54.55"
"705","Zach Whitecloud","VGK","D","59","904.73333333333","5","7","4","3","12","30.00"
"747","Nils Lundkvist","DAL","D","60","866.38333333333","4","8","4","4","12","33.33"
"764","Pontus Holmberg","TOR","R","37","359.7","4","8","6","2","12","85.71"
"855","Cole Smith","NSH","L","69","717.95","3","9","8","1","12","66.67"
"872","Justin Barron","MTL","D","39","559.85","2","10","5","5","12","41.38"
"881","Luke Evangelista","NSH","R","24","301.06666666667","7","5","4","1","12","66.67"
"15","Alexander Edler","L.A","D","64","843.85","2","9","5","4","11","28.21"
"78","John Carlson","WSH","D","40","664.55","3","8","5","3","11","34.38"
"126","Nicolas Deslauriers","PHI","L","80","735.5","5","6","1","5","11","61.11"
"146","Jon Merrill","MIN","D","73","1007.2833333333","2","9","5","4","11","30.56"
"161","Erik Gudbranson","CBJ","D","70","1283.3166666667","1","10","4","6","11","27.50"
"183","Josh Archibald","PIT","R","62","505.06666666667","5","6","2","4","11","52.38"
"218","Joel Armia","MTL","R","43","496.36666666667","5","6","3","3","11","91.67"
"247","Tom Wilson","WSH","R","33","430.08333333333","5","6","4","2","11","55.00"
"341","Rasmus Ristolainen","PHI","D","74","1150.5666666667","1","10","4","6","11","25.58"
"359","Jordan Oesterle","DET","D","52","788.83333333333","2","9","3","6","11","44.00"
"360","Patrick Brown","OTT, PHI","C","61","605.16666666667","3","8","4","4","11","57.89"
"363","Pierre-Edouard Bellemare","T.B","L","73","650.71666666667","4","7","6","1","11","61.11"
"448","A.J. Greer","BOS","L","61","542.5","4","7","4","3","11","52.38"
"464","Caleb Jones","CHI","D","73","1204.3666666667","2","9","4","5","11","25.00"
"582","Rem Pitlick","MTL","C","46","515.9","3","8","6","2","11","78.57"
"626","Jaret Anderson-Dolan","L.A","C","46","456.21666666667","7","4","2","2","11","61.11"
"695","Sean Walker","L.A","D","70","921.66666666667","3","8","5","3","11","27.50"
"696","Mark Kastelic","OTT","C","65","525.66666666667","7","4","2","2","11","64.71"
"706","Kiefer Sherwood","NSH","L","32","380.25","6","5","3","2","11","57.89"
"759","Ilya Lyubushkin","BUF","D","68","865.86666666667","1","10","4","6","11","35.48"
"854","Drew O'Connor","PIT","L","46","421.35","5","6","3","3","11","73.33"
"910","Walker Duehr","CGY","R","27","268.31666666667","7","4","4","0","11","78.57"
"35","Cal Clutterbuck","NYI","R","49","500.16666666667","5","5","2","3","10","55.56"
"51","Sam Gagner","WPG","C","48","495.35","6","4","3","1","10","58.82"
"64","Alec Martinez","VGK","D","77","1285.8","1","9","3","6","10","15.87"
"83","Derek Stepan","CAR","C","73","607.46666666667","5","5","4","1","10","45.45"
"137","Chris Tanev","CGY","D","65","1061.9","1","9","4","5","10","22.22"
"151","Derek Forbort","BOS","D","54","764.78333333333","3","7","5","2","10","31.25"
"182","Josh Manson","COL","D","27","407.81666666667","2","8","6","2","10","43.48"
"206","Scott Harrington","ANA, S.J","D","45","700.81666666667","3","7","3","4","10","30.30"
"215","Jonas Brodin","MIN","D","60","1067.1333333333","2","8","1","7","10","23.81"
"237","Phillip Di Giuseppe","VAN","L","30","383.85","6","4","2","2","10","62.50"
"280","Vinnie Hinostroza","BUF","C","26","317.61666666667","2","8","4","4","10","71.43"
"284","Jaycob Megna","S.J, SEA","D","54","906.96666666667","1","9","4","5","10","22.22"
"285","Liam O'Brien","ARI","C","56","579.4","3","7","4","3","10","62.50"
"297","Saku Maenalanen","WPG","R","64","561.63333333333","4","6","2","4","10","71.43"
"354","Nathan Walker","STL","L","56","535.36666666667","2","8","4","4","10","43.48"
"374","Jakub Vrana","DET, STL","L","25","297.23333333333","6","4","3","1","10","71.43"
"443","Jordan Greenway","BUF, MIN","L","62","769.55","5","5","2","3","10","34.48"
"473","Jeremy Lauzon","NSH","D","67","942.88333333333","3","7","1","6","10","34.48"
"552","Andrew Peeke","CBJ","D","80","1408.1333333333","5","5","2","3","10","22.73"
"609","Zack MacEwen","L.A, PHI","C","56","608.13333333333","4","6","1","5","10","62.50"
"659","Ryan Poehling","PIT","C","53","483.71666666667","4","6","5","1","10","66.67"
"693","Sheldon Dries","VAN","C","63","597.16666666667","6","4","2","2","10","45.45"
"717","Isac Lundestrom","ANA","C","61","705.43333333333","3","7","3","4","10","50.00"
"932","Arber Xhekaj","MTL","D","51","713.73333333333","3","7","5","2","10","41.67"
"41","Nicklas Backstrom","WSH","C","39","487.95","1","8","5","3","9","64.29"
"179","Colin Blackwell","CHI","C","53","536.18333333333","2","7","6","1","9","64.29"
"220","Connor Murphy","CHI","D","80","1345.7333333333","4","5","3","2","9","20.93"
"228","Brad Hunt","COL","D","47","515.75","3","6","3","3","9","45.00"
"242","Mark Jankowski","NSH","C","50","514.05","4","5","3","2","9","75.00"
"260","Devin Shore","EDM","C","47","403.15","1","8","6","2","9","69.23"
"261","Jujhar Khaira","CHI","L","51","571.9","4","5","2","3","9","56.25"
"264","Chris Tierney","FLA, MTL","C","36","340.35","3","6","3","3","9","56.25"
"339","Sean Monahan","MTL","C","25","288.43333333333","3","6","5","1","9","75.00"
"386","Brendan Lemieux","L.A, PHI","L","45","441.05","2","7","5","2","9","60.00"
"520","Joey Anderson","CHI, TOR","R","38","398.78333333333","6","3","3","0","9","60.00"
"554","Dante Fabbro","NSH","D","79","1181.4","1","8","3","5","9","25.00"
"584","Brandon Duhaime","MIN","R","51","493.15","8","1","1","0","9","50.00"
"619","Conor Timmins","ARI, TOR","D","27","365.56666666667","2","7","3","4","9","47.37"
"718","Mattias Samuelsson","BUF","D","55","1026.0666666667","2","7","3","4","9","16.36"
"779","Simon Benoit","ANA","D","78","1233","3","6","1","5","9","22.50"
"792","Brett Leason","ANA","R","54","578.51666666667","6","3","2","1","9","69.23"
"802","Nils Hoglander","VAN","L","25","290.38333333333","3","6","4","2","9","69.23"
"819","Philip Tomasino","NSH","C","31","394.98333333333","1","8","7","1","9","69.23"
"830","Simon Holmstrom","NYI","R","50","534.15","6","3","1","2","9","64.29"
"858","Dylan Holloway","EDM","L","51","449.21666666667","3","6","2","4","9","52.94"
"875","Lukas Reichel","CHI","L","23","304.35","5","4","3","1","9","64.29"
"902","Yegor Chinakhov","CBJ","R","30","348.46666666667","3","6","1","5","9","64.29"
"920","Dylan Guenther","ARI","R","33","360.06666666667","2","7","2","5","9","90.00"
"85","Michael Stone","CGY","D","48","585.55","5","3","1","2","8","27.59"
"155","Austin Watson","OTT","L","75","598.86666666667","6","2","1","1","8","61.54"
"166","Jarred Tinordi","CHI","D","44","639.48333333333","2","6","2","4","8","50.00"
"203","Joel Edmundson","MTL","D","61","948.15","2","6","1","5","8","22.22"
"308","Anthony Duclair","FLA","L","20","258.38333333333","1","7","5","2","8","57.14"
"413","Anders Bjork","BUF, CHI","L","14","172.45","2","6","5","1","8","88.89"
"562","Riley Stillman","BUF, VAN","D","50","677.05","1","7","2","5","8","26.67"
"598","Dylan Gambrell","OTT","C","60","544.83333333333","4","4","3","1","8","53.33"
"620","Mario Ferraro","S.J","D","72","1253.7666666667","2","6","1","5","8","19.05"
"641","Jack Studnicka","BOS, VAN","C","48","473.51666666667","4","4","1","3","8","100.00"
"643","MacKenzie Entwistle","CHI","R","66","677","3","5","1","4","8","47.06"
"672","Jan Rutta","PIT","D","56","802.31666666667","3","5","0","5","8","28.57"
"673","Gustav Lindstrom","DET","D","36","502.33333333333","1","7","3","4","8","57.14"
"740","Kevin Bahl","N.J","D","42","548.45","2","6","2","4","8","33.33"
"827","Philip Broberg","EDM","D","46","523.61666666667","1","7","2","5","8","27.59"
"849","Elmer Soderblom","DET","L","21","226.48333333333","5","3","1","2","8","66.67"
"863","Jake Neighbours","STL","L","43","477.13333333333","5","3","1","2","8","57.14"
"937","Juraj Slafkovsky","MTL","L","39","421.03333333333","3","5","1","4","8","80.00"
"940","Nick Blankenburg","CBJ","D","36","580.76666666667","3","5","3","2","8","34.78"
"31","Erik Johnson","COL","D","63","930.83333333333","0","7","4","3","7","19.44"
"181","Lukas Sedlak","COL, PHI","C","30","303.5","3","4","3","1","7","63.64"
"287","Jayson Megna","ANA, COL","C","55","494.91666666667","2","5","2","3","7","70.00"
"302","Josh Brown","ARI","D","68","854.26666666667","4","3","2","1","7","18.92"
"324","Robert Hagg","DET","D","38","542.51666666667","2","5","4","1","7","38.89"
"521","Luke Kunin","S.J","C","31","354.21666666667","3","4","3","1","7","58.33"
"578","Jacob MacDonald","COL, S.J","D","58","642.43333333333","1","6","3","3","7","41.18"
"580","Nikita Zaitsev","CHI, OTT","D","46","641.98333333333","1","6","2","4","7","30.43"
"618","Jonah Gadjovich","S.J","L","35","311.25","3","4","1","3","7","53.85"
"621","Cal Foote","NSH, T.B","D","50","683.98333333333","2","5","2","3","7","23.33"
"661","Ian Mitchell","CHI","D","35","497.11666666667","1","6","2","4","7","38.89"
"677","Jacob Bryson","BUF","D","59","786.31666666667","1","6","3","3","7","28.00"
"722","Filip Zadina","DET","R","30","361.08333333333","3","4","2","2","7","87.50"
"723","Martin Kaut","COL, S.J","R","36","329.68333333333","3","4","1","3","7","58.33"
"729","Jack Drury","CAR","C","38","362.91666666667","2","5","3","2","7","53.85"
"749","Jakub Lauko","BOS","C","23","195","4","3","3","0","7","70.00"
"751","Calen Addison","MIN","D","62","746.73333333333","3","4","1","3","7","25.93"
"807","Nikita Alexandrov","STL","C","28","263.81666666667","3","4","3","1","7","87.50"
"835","Vasily Podkolzin","VAN","R","39","438.58333333333","4","3","2","1","7","53.85"
"838","Joel Kiviranta","DAL","L","70","725.65","6","1","0","1","7","53.85"
"856","Connor Mackey","ARI, CGY","D","30","375.43333333333","3","4","1","3","7","33.33"
"895","Artem Zub","OTT","D","53","944.36666666667","1","6","1","5","7","20.00"
"921","Cole Sillinger","CBJ","C","64","734.6","1","6","4","2","7","35.00"
"171","Sam Carrick","ANA","C","52","494.46666666667","3","3","2","1","6","46.15"
"282","Ben Hutton","VGK","D","31","452.11666666667","2","4","2","2","6","37.50"
"286","Kurtis MacDermid","COL","D","44","351.25","1","5","3","2","6","54.55"
"314","Ben Harpur","NYR","D","42","576.78333333333","1","5","0","5","6","27.27"
"468","Zach Werenski","CBJ","D","13","243.45","3","3","3","0","6","42.86"
"494","Kevin Stenlund","WPG","C","54","488.46666666667","3","3","1","2","6","42.86"
"499","Alexandre Carrier","NSH","D","43","630.03333333333","1","5","2","3","6","30.00"
"501","Niko Mikkola","NYR, STL","D","81","1238.65","1","5","2","3","6","11.11"
"510","Lane Pederson","CBJ, VAN","C","27","297.41666666667","3","3","3","0","6","40.00"
"532","Rasmus Asplund","BUF, NSH","C","46","452.35","1","5","1","4","6","42.86"
"549","Logan Brown","STL","C","30","284.06666666667","2","4","2","2","6","75.00"
"655","Dylan Samberg","WPG","D","63","799.16666666667","2","4","1","3","6","20.69"
"680","Jacob Peterson","DAL, S.J","C","12","166.13333333333","0","6","3","3","6","85.71"
"756","Karson Kuhlman","SEA, WPG","C","47","495.93333333333","2","4","1","3","6","42.86"
"780","Reese Johnson","CHI","C","57","558.01666666667","4","2","1","1","6","42.86"
"828","Victor Soderstrom","ARI","D","30","434.55","0","6","2","4","6","35.29"
"864","Ridly Greig","OTT","C","20","223.66666666667","2","4","3","1","6","50.00"
"18","Jack Johnson","CHI, COL","D","83","1375","2","3","1","2","5","13.16"
"57","Robert Bortuzzo","STL","D","43","454.55","2","3","2","1","5","22.73"
"72","Zach Bogosian","T.B","D","46","650.75","1","4","3","1","5","20.00"
"136","Matt Irwin","WSH","D","61","736.08333333333","2","3","1","2","5","22.73"
"290","Chad Ruhwedel","PIT","D","47","587.66666666667","1","4","1","3","5","23.81"
"349","Curtis Lazar","N.J, VAN","C","49","518.78333333333","3","2","1","1","5","35.71"
"381","Robby Fabbri","DET","C","28","350.13333333333","2","3","1","2","5","50.00"
"442","Anthony Richard","MTL","C","13","124.66666666667","3","2","1","1","5","71.43"
"449","Jansen Harkins","WPG","C","22","234.61666666667","3","2","1","1","5","50.00"
"503","Rudolfs Balcers","FLA, T.B","L","17","164.06666666667","3","2","1","1","5","62.50"
"568","Jake Bean","CBJ","D","14","197.98333333333","1","4","0","4","5","55.56"
"687","Cole Guttman","CHI","C","14","175.8","3","2","2","0","5","83.33"
"728","Vitali Kravtsov","NYR, VAN","R","44","458.13333333333","3","2","0","2","5","38.46"
"768","David Gustafsson","WPG","C","46","383.16666666667","0","5","4","1","5","41.67"
"831","Pavel Dorofeyev","VGK","L","18","220.76666666667","4","1","1","0","5","50.00"
"890","Isaak Phillips","CHI","D","16","231.36666666667","1","4","2","2","5","55.56"
"54","Brendan Smith","N.J","D","60","822.15","0","4","1","3","4","13.79"
"62","Jakub Voracek","CBJ","R","11","133.7","0","4","2","2","4","80.00"
"81","Zac Dalpe","FLA","C","14","113.66666666667","2","2","1","1","4","66.67"
"123","Chris Wideman","MTL","D","46","555.33333333333","0","4","2","2","4","16.67"
"219","Nathan Beaulieu","ANA","D","52","668.81666666667","0","4","2","2","4","17.39"
"240","Tanner Pearson","VAN","L","14","155.01666666667","1","3","2","1","4","66.67"
"293","Kyle Burroughs","VAN","D","48","734.33333333333","2","2","2","0","4","19.05"
"401","Fredrik Olofsson","DAL","L","28","282.26666666667","1","3","3","0","4","50.00"
"445","Jakub Zboril","BOS","D","22","251.1","1","3","1","2","4","36.36"
"484","Dennis Gilbert","CGY","D","23","262.5","1","3","1","2","4","36.36"
"488","Austin Czarnik","DET","C","29","297.41666666667","3","1","1","0","4","44.44"
"496","Colton White","ANA","D","46","607.8","0","4","2","2","4","20.00"
"542","Kale Clague","BUF","D","33","484.06666666667","0","4","0","4","4","16.67"
"559","Givani Smith","DET, FLA","R","36","249.15","1","3","2","1","4","57.14"
"596","Vincent Desharnais","EDM","D","36","402.51666666667","0","4","3","1","4","20.00"
"603","Matt Luff","DET","R","19","186.38333333333","2","2","2","0","4","80.00"
"662","Robin Salo","NYI","D","11","114.83333333333","2","2","1","1","4","57.14"
"724","Alexander Alexeyev","WSH","D","32","479.71666666667","0","4","2","2","4","20.00"
"765","Tyler Tucker","STL","D","26","364.78333333333","1","3","0","3","4","33.33"
"783","Egor Zamula","PHI","D","14","178.31666666667","0","4","2","2","4","57.14"
"822","Nicholas Robertson","TOR","L","15","142.7","1","3","0","3","4","66.67"
"825","Jakob Pelletier","CGY","L","24","281.75","1","3","1","2","4","50.00"
"885","Tyson Foerster","PHI","R","8","106.55","2","2","2","0","4","57.14"
"909","Matt Kiersted","FLA","D","20","186.21666666667","1","3","2","1","4","40.00"
"929","Nick Cicek","S.J","D","16","217.28333333333","0","4","1","3","4","100.00"
"930","Jesper Froden","SEA","R","14","137.2","0","4","2","2","4","57.14"
"941","Ben Meyers","COL","C","39","360.66666666667","4","0","0","0","4","44.44"
"944","Marcus Bjork","CBJ","D","33","486.83333333333","2","2","1","1","4","25.00"
"145","Patrik Nemeth","ARI","D","75","1067.0166666667","0","3","1","2","3","12.00"
"230","Luke Glendening","DAL","C","70","661.28333333333","1","2","0","2","3","30.00"
"232","Ryan Murray","EDM","D","13","159.81666666667","0","3","2","1","3","60.00"
"288","Buddy Robinson","CHI","R","9","102.2","1","2","1","1","3","75.00"
"294","Andreas Johnsson","N.J, S.J","L","13","153.41666666667","0","3","1","2","3","75.00"
"317","Michael McCarron","NSH","R","32","290.01666666667","2","1","1","0","3","50.00"
"326","Nic Petan","MIN","C","10","111.83333333333","1","2","1","1","3","42.86"
"332","Zach Sanford","NSH","L","16","186.71666666667","2","1","1","0","3","60.00"
"358","Ryan Carpenter","NYR","C","22","176.28333333333","1","2","1","1","3","50.00"
"389","Andreas Englund","CHI, COL","D","47","530.11666666667","0","3","2","1","3","21.43"
"399","Mark Friedman","PIT","D","23","301.46666666667","1","2","1","1","3","25.00"
"425","Darren Raddysh","T.B","D","17","261.28333333333","1","2","1","1","3","23.08"
"426","Dryden Hunt","COL, NYR, TOR","L","37","295.48333333333","3","0","0","0","3","60.00"
"513","Philippe Myers","T.B","D","11","120.13333333333","1","2","0","2","3","42.86"
"545","Kieffer Bellows","NYI, PHI","L","28","256.9","3","0","0","0","3","50.00"
"558","Logan Stanley","WPG","D","19","233.6","1","2","1","1","3","33.33"
"594","Tanner Laczynski","PHI","C","32","289.78333333333","2","1","1","0","3","75.00"
"597","Casey Fitzgerald","BUF, FLA","D","27","276.16666666667","0","3","2","1","3","27.27"
"601","Michael Carcone","ARI","L","9","110.1","2","1","0","1","3","50.00"
"602","Dylan Coghlan","CAR","D","17","196.21666666667","0","3","2","1","3","37.50"
"610","Justin Danforth","CBJ","R","6","63.683333333333","2","1","1","0","3","75.00"
"651","Aleksi Heponiemi","FLA","C","10","84.066666666667","1","2","1","1","3","75.00"
"658","Josh Norris","OTT","C","8","100.7","2","1","0","1","3","75.00"
"671","Radim Simek","S.J","D","44","581.95","1","2","2","0","3","18.75"
"701","Parker Kelly","OTT","L","55","450.35","1","2","0","2","3","42.86"
"754","Michael Kesselring","ARI","D","9","133.45","0","3","3","0","3","60.00"
"758","Lawrence Pilut","BUF","D","17","196.1","1","2","0","2","3","33.33"
"775","Tim Berni","CBJ","D","59","950.86666666667","1","2","1","1","3","9.68"
"781","Jake Christiansen","CBJ","D","24","340.7","0","3","1","2","3","25.00"
"785","Samuel Fagemo","L.A","L","9","70.433333333333","2","1","1","0","3","100.00"
"788","Joe Snively","WSH","C","12","148.53333333333","2","1","1","0","3","37.50"
"805","Samuel Bolduc","NYI","D","17","215.31666666667","2","1","1","0","3","30.00"
"887","Wyatt Kaiser","CHI","D","9","146.25","0","3","0","3","3","60.00"
"906","Daniil Miromanov","VGK","D","14","215.45","1","2","2","0","3","50.00"
"919","Aatu Raty","NYI, VAN","C","15","117.78333333333","2","1","1","0","3","100.00"
"943","Filip Roos","CHI","D","17","251.53333333333","1","2","0","2","3","33.33"
"945","Pavol Regenda","ANA","L","14","135.48333333333","1","2","1","1","3","75.00"
"13","Alex Goligoski","MIN","D","46","706.91666666667","0","2","2","0","2","9.52"
"28","Patric Hornqvist","FLA","R","22","147.51666666667","1","1","1","0","2","66.67"
"47","Justin Braun","PHI","D","51","670.83333333333","0","2","2","0","2","9.09"
"61","Max Pacioretty","CAR","L","5","45.283333333333","2","0","0","0","2","100.00"
"66","Wayne Simmonds","TOR","R","18","132.51666666667","0","2","1","1","2","50.00"
"84","Marco Scandella","STL","D","20","298.68333333333","1","1","1","0","2","10.53"
"93","Jordie Benn","TOR","D","12","167.15","1","1","1","0","2","28.57"
"110","Zack Kassian","ARI","R","51","461.55","2","0","0","0","2","40.00"
"127","Byron Froese","VGK","C","9","84.633333333333","1","1","1","0","2","100.00"
"134","Andrew Agozzino","S.J","L","4","56.1","0","2","1","1","2","100.00"
"250","Derrick Pouliot","S.J","D","8","123.6","0","2","1","1","2","33.33"
"301","Jonny Brodzinski","NYR","C","17","150.01666666667","1","1","0","1","2","40.00"
"304","John Hayden","SEA","C","7","55.383333333333","2","0","0","0","2","100.00"
"352","Ross Johnston","NYI","L","16","124.08333333333","0","2","2","0","2","50.00"
"355","Joel Hanley","DAL","D","26","298.85","0","2","1","1","2","16.67"
"466","Austin Wagner","CHI","L","7","84.116666666667","1","1","1","0","2","100.00"
"471","Guillaume Brisebois","VAN","D","17","241.58333333333","1","1","0","1","2","25.00"
"477","Kyle Capobianco","WPG","D","14","158.48333333333","2","0","0","0","2","28.57"
"485","Gabriel Carlsson","WSH","D","6","74.483333333333","0","2","1","1","2","66.67"
"498","Christian Wolanin","VAN","D","16","220.33333333333","0","2","1","1","2","25.00"
"546","Beck Malenstyn","WSH","L","9","85.5","1","1","1","0","2","66.67"
"557","Victor Mete","TOR","D","11","129.85","0","2","0","2","2","25.00"
"576","Alex Nylander","PIT","L","9","108.95","1","1","0","1","2","40.00"
"587","Otto Koivula","NYI","L","8","48.016666666667","0","2","0","2","2","100.00"
"630","Urho Vaakanainen","ANA","D","23","360.46666666667","0","2","1","1","2","33.33"
"656","Jack Rathbone","VAN","D","11","140.08333333333","1","1","0","1","2","28.57"
"698","Mac Hollowell","TOR","D","6","75.383333333333","0","2","1","1","2","33.33"
"733","Grigori Denisenko","FLA","L","18","168","0","2","1","1","2","50.00"
"757","Jordan Gross","NSH","D","15","238.55","2","0","0","0","2","18.18"
"778","Egor Sokolov","OTT","L","5","32.8","1","1","1","0","2","50.00"
"798","Kaedan Korczak","VGK","D","10","168.18333333333","0","2","1","1","2","28.57"
"815","Henry Thrun","S.J","D","8","142.63333333333","0","2","1","1","2","28.57"
"821","Thomas Harley","DAL","D","6","96.216666666667","0","2","1","1","2","28.57"
"845","Zac Jones","NYR","D","16","232.71666666667","1","1","0","1","2","25.00"
"851","Lukas Rousek","BUF","R","2","22.616666666667","1","1","0","1","2","66.67"
"866","Tyler Kleven","OTT","D","8","103.8","0","2","1","1","2","50.00"
"878","Alexander Holtz","N.J","R","19","157.15","1","1","1","0","2","50.00"
"879","Thomas Bordeleau","S.J","C","8","103.71666666667","0","2","1","1","2","100.00"
"928","Simon Edvinsson","DET","D","9","147.08333333333","2","0","0","0","2","40.00"
"938","Shane Wright","SEA","C","8","64.433333333333","1","1","0","1","2","40.00"
"948","Hunter McKown","CBJ","C","12","124.8","0","2","1","1","2","50.00"
"63","Jake Muzzin","TOR","D","4","52.833333333333","0","1","1","0","1","50.00"
"99","Kyle Clifford","TOR","L","2","15.816666666667","0","1","0","1","1","100.00"
"100","Alex Chiasson","DET","R","20","177.48333333333","0","1","0","1","1","50.00"
"165","Dylan McIlrath","WSH","D","6","67.916666666667","0","1","0","1","1","50.00"
"174","Kevin Gravel","NSH","D","23","298.45","0","1","1","0","1","20.00"
"190","Joseph Cramarossa","MIN","C","4","30.5","1","0","0","0","1","100.00"
"195","Andy Andreoff","NYI","C","3","20.383333333333","0","1","0","1","1","100.00"
"198","Mike Reilly","BOS","D","10","148.91666666667","0","1","0","1","1","16.67"
"271","Connor Carrick","BOS","D","1","16","0","1","1","0","1","33.33"
"273","Dominic Toninato","WPG","C","5","39.016666666667","0","1","0","1","1","50.00"
"298","Tucker Poolman","VAN","D","3","36.85","0","1","1","0","1","100.00"
"323","Laurent Dauphin","ARI","C","21","216.18333333333","1","0","0","0","1","33.33"
"325","Steven Santini","STL","D","4","47.083333333333","0","1","1","0","1","50.00"
"369","Haydn Fleury","T.B","D","29","340.06666666667","0","1","0","1","1","16.67"
"427","Luke Philp","CHI","C","3","34.2","0","1","1","0","1","50.00"
"441","Travis Dermott","VAN","D","11","136.55","1","0","0","0","1","20.00"
"462","Parker Wotherspoon","NYI","D","12","156.4","0","1","0","1","1","14.29"
"505","Brett Seney","CHI","L","7","85.45","1","0","0","0","1","50.00"
"516","Kevin Rooney","CGY","C","17","143.91666666667","0","1","1","0","1","25.00"
"518","Kyle Criscuolo","S.J","C","1","11.75","1","0","0","0","1","100.00"
"531","Libor Hajek","NYR","D","16","209.68333333333","1","0","0","0","1","14.29"
"550","William Lockwood","VAN","R","13","125.53333333333","0","1","0","1","1","100.00"
"556","William Bitten","STL","C","4","26.583333333333","0","1","1","0","1","100.00"
"588","Joona Koppanen","BOS","L","5","45.033333333333","0","1","0","1","1","100.00"
"592","Oskar Steen","BOS","C","3","27.466666666667","1","0","0","0","1","50.00"
"622","Cale Fleury","SEA","D","12","153.61666666667","0","1","0","1","1","20.00"
"633","Jonas Rondbjerg","VGK","R","13","121.43333333333","0","1","1","0","1","100.00"
"648","Joel Teasdale","MTL","L","2","20.5","0","1","0","1","1","100.00"
"685","Olle Lycksell","PHI","R","8","83.916666666667","0","1","0","1","1","100.00"
"688","Samuel Walker","MIN","C","9","94.25","0","1","1","0","1","50.00"
"692","Carson Meyer","CBJ","R","14","129.76666666667","0","1","1","0","1","50.00"
"694","David Gust","CHI","R","4","50.666666666667","1","0","0","0","1","50.00"
"699","Trey Fix-Wolansky","CBJ","R","9","105.31666666667","1","0","0","0","1","50.00"
"700","Kristian Reichel","WPG","C","2","21.116666666667","0","1","0","1","1","100.00"
"748","Jacob Bernard-Docker","OTT","D","19","290.43333333333","0","1","0","1","1","14.29"
"750","Ty Smith","PIT","D","9","130","1","0","0","0","1","16.67"
"763","Damien Giroux","MIN","C","1","12.866666666667","0","1","0","1","1","100.00"
"770","Cole Koepke","T.B","L","17","151.86666666667","1","0","0","0","1","33.33"
"776","John Leonard","NSH","L","6","66.466666666667","1","0","0","0","1","100.00"
"782","Brayden Pachal","VGK","D","10","153.01666666667","0","1","0","1","1","25.00"
"789","Corey Schueneman","MTL","D","7","101.58333333333","0","1","0","1","1","25.00"
"793","Nolan Foote","N.J","L","6","43.283333333333","1","0","0","0","1","50.00"
"803","Nikita Okhotiuk","N.J","D","10","114","1","0","0","0","1","16.67"
"814","Drew Helleson","ANA","D","3","40.466666666667","1","0","0","0","1","50.00"
"817","Ville Heinola","WPG","D","10","118.61666666667","0","1","1","0","1","33.33"
"823","Egor Afanasyev","NSH","L","17","179.61666666667","1","0","0","0","1","33.33"
"833","Jordan Spence","L.A","D","6","71.15","0","1","1","0","1","33.33"
"839","Joona Luoto","CBJ","L","7","84.233333333333","1","0","0","0","1","50.00"
"842","Aidan McDonough","VAN","L","6","54.1","1","0","0","0","1","100.00"
"843","Tyler Angle","CBJ","C","2","22.25","1","0","0","0","1","100.00"
"847","Matej Blumel","DAL","R","6","55.866666666667","1","0","0","0","1","100.00"
"848","Nick Abruzzese","TOR","C","2","16.383333333333","0","1","1","0","1","100.00"
"852","Nikita Nesterenko","ANA","C","9","113.56666666667","1","0","0","0","1","50.00"
"853","Nikolai Knyzhov","S.J","D","12","171.13333333333","1","0","0","0","1","33.33"
"860","Marco Rossi","MIN","C","19","207.26666666667","0","1","1","0","1","33.33"
"861","Sean Farrell","MTL","C","6","74.483333333333","1","0","0","0","1","100.00"
"888","Justin Richards","CBJ","C","2","18.3","0","1","0","1","1","100.00"
"894","Radim Zohorna","CGY, TOR","L","10","80.033333333333","1","0","0","0","1","33.33"
"897","Bobby McMann","TOR","C","10","103.31666666667","0","1","0","1","1","50.00"
"898","Billy Sweezey","CBJ","D","9","131.8","0","1","0","1","1","33.33"
"915","William Eklund","S.J","L","8","115.83333333333","1","0","0","0","1","50.00"
"918","Luke Hughes","N.J","D","2","30.65","0","1","0","1","1","100.00"
"924","Matthew Knies","TOR","L","3","36.066666666667","0","1","1","0","1","50.00"
"925","Brandt Clarke","L.A","D","9","106.43333333333","0","1","1","0","1","12.50"
"931","Vincent Iorio","WSH","D","3","39.433333333333","0","1","1","0","1","33.33"
"939","Lucas Condotta","MTL","C","1","11.033333333333","1","0","0","0","1","100.00"
"942","Milos Kelemen","ARI","L","14","105.38333333333","1","0","0","0","1","100.00"
"949","Akito Hirose","VAN","D","7","99.35","0","1","0","1","1","50.00"
"950","Jake Livingstone","NSH","D","5","75.266666666667","0","1","0","1","1","50.00"
"951","Cole McWard","VAN","D","5","69.05","1","0","0","0","1","100.00"
"25","Darren Helm","COL","C","11","82.833333333333","0","0","0","0","0","0.00"
"27","Anton Stralman","BOS","D","8","115.3","0","0","0","0","0","0.00"
"53","Brad Malone","EDM","C","10","64.183333333333","0","0","0","0","0","-"
"68","Jason Demers","EDM","D","1","10.733333333333","0","0","0","0","0","-"
"90","Mark Borowiecki","NSH","D","4","34.316666666667","0","0","0","0","0","0.00"
"157","Riley Sheahan","BUF","C","2","16.266666666667","0","0","0","0","0","-"
"158","Chris Wagner","BOS","R","1","11.816666666667","0","0","0","0","0","-"
"178","Taylor Fedun","PIT","D","4","43.483333333333","0","0","0","0","0","0.00"
"193","Steven Fogarty","MIN","C","2","19.3","0","0","0","0","0","-"
"233","Alex Galchenyuk","COL","C","11","73.116666666667","0","0","0","0","0","-"
"238","Brendan Gaunce","CBJ","C","5","48.866666666667","0","0","0","0","0","-"
"272","Charles Hudon","COL","L","9","85.866666666667","0","0","0","0","0","0.00"
"281","Connor Brown","WSH","R","4","48.866666666667","0","0","0","0","0","0.00"
"291","Anton Blidh","COL","L","14","91.333333333333","0","0","0","0","0","-"
"327","Gustav Olofsson","SEA","D","3","35.416666666667","0","0","0","0","0","0.00"
"328","Dillon Heatherington","OTT","D","3","27.633333333333","0","0","0","0","0","-"
"351","Jean-Sebastien Dea","ARI","C","4","37.8","0","0","0","0","0","0.00"
"353","Dakota Mermis","MIN","D","2","27.083333333333","0","0","0","0","0","-"
"391","Roland McKeown","NSH","D","6","72.783333333333","0","0","0","0","0","0.00"
"395","Justin Kirkland","ANA","C","7","50.466666666667","0","0","0","0","0","0.00"
"407","Max Willman","PHI","C","9","80.333333333333","0","0","0","0","0","0.00"
"410","CJ Suess","S.J","L","1","5.7333333333333","0","0","0","0","0","-"
"411","Dysin Mayo","ARI","D","15","152.23333333333","0","0","0","0","0","0.00"
"414","Rourke Chartier","OTT","C","6","50.366666666667","0","0","0","0","0","0.00"
"419","Ondrej Kase","CAR","R","1","9.1333333333333","0","0","0","0","0","-"
"422","Matthew Highmore","STL","C","2","18.833333333333","0","0","0","0","0","0.00"
"423","Bokondji Imama","ARI","L","5","37.333333333333","0","0","0","0","0","-"
"424","Hayden Hodgson","PHI","R","1","4.6333333333333","0","0","0","0","0","-"
"430","Cole Bardreau","NYI","C","1","6.6166666666667","0","0","0","0","0","-"
"431","Nikita Soshnikov","NYI","R","3","26.4","0","0","0","0","0","-"
"460","Glenn Gawdin","ANA","C","3","21.866666666667","0","0","0","0","0","-"
"465","Noah Juulsen","VAN","D","12","161.86666666667","0","0","0","0","0","0.00"
"479","Jacob Larsson","OTT","D","7","80.183333333333","0","0","0","0","0","0.00"
"515","Dan Renouf","BOS","D","1","8.9166666666667","0","0","0","0","0","-"
"523","Maxime Lajoie","CAR","D","3","22.95","0","0","0","0","0","-"
"524","Lucas Johansen","WSH","D","2","25.316666666667","0","0","0","0","0","-"
"530","Frederic Allard","MTL","D","3","39.4","0","0","0","0","0","0.00"
"535","Markus Niemelainen","EDM","D","23","210.01666666667","0","0","0","0","0","0.00"
"541","Tyler Benson","EDM","L","2","12.066666666667","0","0","0","0","0","-"
"547","Riley Tufte","DAL","L","3","23.666666666667","0","0","0","0","0","-"
"565","Dennis Cholowski","NYI","D","2","20.416666666667","0","0","0","0","0","0.00"
"569","Henrik Borgstrom","WSH","C","1","8.1666666666667","0","0","0","0","0","-"
"575","Jacob Moverare","L.A","D","2","29.466666666667","0","0","0","0","0","0.00"
"581","Drake Caggiula","PIT","C","4","26.4","0","0","0","0","0","0.00"
"583","Fredrik Karlstrom","DAL","C","5","47.15","0","0","0","0","0","0.00"
"585","Lucas Carlsson","FLA","D","2","19.5","0","0","0","0","0","-"
"593","Matthew Phillips","CGY","C","2","12.383333333333","0","0","0","0","0","-"
"595","Mikhail Maltsev","COL","L","5","32.983333333333","0","0","0","0","0","-"
"600","Jeremy Davies","BUF","D","1","8.4666666666667","0","0","0","0","0","-"
"607","Jeffrey Viel","S.J","L","4","35.866666666667","0","0","0","0","0","0.00"
"608","Alex Barré-Boulet","T.B","C","1","9.9166666666667","0","0","0","0","0","-"
"613","Vinni Lettieri","BOS","C","1","9.8333333333333","0","0","0","0","0","-"
"624","Jake Leschyshyn","NYR, VGK","C","35","311.51666666667","0","0","0","0","0","0.00"
"647","Shane Bowers","COL","C","1","1.7666666666667","0","0","0","0","0","-"
"653","Dmitri Samorukov","STL","D","2","29.7","0","0","0","0","0","-"
"663","Lias Andersson","L.A","C","1","8.6166666666667","0","0","0","0","0","-"
"666","Nick DeSimone","CGY","D","4","41.466666666667","0","0","0","0","0","0.00"
"683","Marian Studenic","DAL","L","3","26.016666666667","0","0","0","0","0","-"
"684","Arnaud Durandeau","NYI","L","4","47.616666666667","0","0","0","0","0","0.00"
"689","Nick Swaney","MIN","R","1","9.2166666666667","0","0","0","0","0","-"
"703","Austin Strand","ANA","D","5","61.366666666667","0","0","0","0","0","-"
"704","James Hamblin","EDM","L","10","80.033333333333","0","0","0","0","0","0.00"
"708","Sheldon Rempal","VGK","R","1","7.7333333333333","0","0","0","0","0","-"
"721","Filip Kral","TOR","D","2","18.05","0","0","0","0","0","0.00"
"727","Alec Regula","CHI","D","4","57.75","0","0","0","0","0","-"
"730","Jonathan Gruden","PIT","C","3","14.566666666667","0","0","0","0","0","-"
"732","Filip Hallander","PIT","C","2","15.716666666667","0","0","0","0","0","-"
"735","Sampo Ranta","COL","L","6","43.833333333333","0","0","0","0","0","0.00"
"741","Gabriel Fortier","T.B","L","1","8.4166666666667","0","0","0","0","0","-"
"743","Benoit-Olivier Groulx","ANA","C","2","22.883333333333","0","0","0","0","0","0.00"
"746","Adam Ginning","PHI","D","1","15.566666666667","0","0","0","0","0","0.00"
"753","Jan Jenik","ARI","R","2","11.716666666667","0","0","0","0","0","-"
"760","Semyon Der-Arguchintsev","TOR","C","1","6.3666666666667","0","0","0","0","0","0.00"
"761","Nathan Smith","ARI","C","4","29.366666666667","0","0","0","0","0","-"
"771","Spencer Stastney","NSH","D","8","122.33333333333","0","0","0","0","0","0.00"
"774","Hugh McGing","STL","L","1","9.0833333333333","0","0","0","0","0","-"
"786","Jacob Lucchini","OTT","C","11","108.25","0","0","0","0","0","-"
"787","Taro Hirose","DET","L","3","30.983333333333","0","0","0","0","0","-"
"794","Ronnie Attard","PHI","D","2","28.2","0","0","0","0","0","0.00"
"800","Alex Turcotte","L.A","C","4","27.566666666667","0","0","0","0","0","-"
"809","Adam Beckman","MIN","L","9","88.1","0","0","0","0","0","-"
"816","Alex Vlasic","CHI","D","6","101.73333333333","0","0","0","0","0","0.00"
"818","Lassi Thomson","OTT","D","2","21.6","0","0","0","0","0","-"
"820","Connor McMichael","WSH","C","6","52.566666666667","0","0","0","0","0","0.00"
"824","Sam Poulin","PIT","R","3","25.583333333333","0","0","0","0","0","-"
"829","Tobias Bjornfot","L.A","D","10","129.05","0","0","0","0","0","0.00"
"832","Jackson LaCombe","ANA","D","2","33.483333333333","0","0","0","0","0","0.00"
"834","Vladislav Kolyachonok","ARI","D","2","23.833333333333","0","0","0","0","0","-"
"841","Maxence Guenette","OTT","D","1","8.7833333333333","0","0","0","0","0","-"
"850","Tyce Thompson","N.J","R","2","17.3","0","0","0","0","0","-"
"868","Danil Gushchin","S.J","L","2","26.183333333333","0","0","0","0","0","0.00"
"876","Brock Faber","MIN","D","2","34.133333333333","0","0","0","0","0","0.00"
"880","Jamie Drysdale","ANA","D","8","125.8","0","0","0","0","0","0.00"
"882","Jean-Luc Foudy","COL","C","9","82.083333333333","0","0","0","0","0","0.00"
"884","Will Cuylle","NYR","L","4","27.616666666667","0","0","0","0","0","-"
"889","Tristen Robins","S.J","C","3","37.033333333333","0","0","0","0","0","-"
"891","Adam Raska","S.J","R","3","35.75","0","0","0","0","0","0.00"
"892","William Dufour","NYI","R","1","6.8","0","0","0","0","0","-"
"896","Callahan Burke","COL","C","2","17.016666666667","0","0","0","0","0","-"
"899","Samuel Knazko","CBJ","D","2","30.316666666667","0","0","0","0","0","0.00"
"900","Mikael Pyyhtia","CBJ","L","2","23.933333333333","0","0","0","0","0","0.00"
"901","Elliot Desnoyers","PHI","L","4","46.166666666667","0","0","0","0","0","0.00"
"904","Matthew Kessel","STL","D","2","29.1","0","0","0","0","0","-"
"905","Josh Dunne","CBJ","C","8","67.966666666667","0","0","0","0","0","-"
"907","Alex Steeves","TOR","C","3","23.4","0","0","0","0","0","-"
"908","Mike Hardman","CHI","L","8","80.016666666667","0","0","0","0","0","-"
"911","Jackson Cates","PHI","C","5","44.7","0","0","0","0","0","0.00"
"917","Matt Coronato","CGY","R","1","14.633333333333","0","0","0","0","0","0.00"
"922","Stanislav Svozil","CBJ","D","2","36.85","0","0","0","0","0","-"
"923","Oskar Olausson","COL","R","1","7.0333333333333","0","0","0","0","0","-"
"933","Marc McLaughlin","BOS","C","2","17.533333333333","0","0","0","0","0","-"
"934","Owen Beck","MTL","C","1","9.65","0","0","0","0","0","-"
"935","David Jiricek","CBJ","D","4","62.216666666667","0","0","0","0","0","0.00"
"936","Marco Kasper","DET","C","1","14.816666666667","0","0","0","0","0","-"
"946","Anton Levtchi","FLA","L","2","17.666666666667","0","0","0","0","0","-"