"","Player","Team","Position","GP","TOI","Goals","Total Assists","First Assists","Second Assists","Total Points","IPP"
"286","Nathan MacKinnon","COL","C","82","1386.3833333333","36","43","25","18","79","79.00"
"381","Connor McDavid","EDM","C","76","1233.25","19","53","32","21","72","80.00"
"169","Nikita Kucherov","T.B","R","81","1307.5833333333","21","46","29","17","67","82.72"
"457","Auston Matthews","TOR","C","81","1241.1833333333","38","23","17","6","61","75.31"
"429","Artemi Panarin","NYR","L","82","1259.5833333333","32","28","14","14","60","83.33"
"334","David Pastrnak","BOS","R","82","1204.3333333333","27","31","23","8","58","80.56"
"12","Sidney Crosby","PIT","C","82","1244.7","23","34","24","10","57","74.03"
"318","Leon Draisaitl","EDM","C","81","1256.7","15","40","23","17","55","72.37"
"389","Mikko Rantanen","COL","R","80","1368.15","24","30","16","14","54","62.07"
"131","Zach Hyman","EDM","L","80","1233.3333333333","36","16","6","10","52","57.78"
"346","Brayden Point","T.B","C","81","1222.1166666667","28","23","12","11","51","72.86"
"494","Jesper Bratt","N.J","L","82","1124.5833333333","16","34","25","9","50","71.43"
"180","J.T. Miller","VAN","C","81","1085.2666666667","20","28","17","11","48","75.00"
"512","Brandon Hagel","T.B","L","82","1217.1833333333","16","32","23","9","48","73.85"
"211","Filip Forsberg","NSH","L","82","1154.75","27","20","12","8","47","73.44"
"322","Nikolaj Ehlers","WPG","L","82","1073.7333333333","20","27","17","10","47","75.81"
"438","Kirill Kaprizov","MIN","L","75","1204.0333333333","21","26","18","8","47","65.28"
"621","Brady Tkachuk","OTT","L","81","1182.4333333333","23","24","20","4","47","73.44"
"554","Elias Pettersson","VAN","C","82","1089.9","14","32","23","9","46","68.66"
"321","William Nylander","TOR","R","82","1166.7","22","23","16","7","45","78.95"
"418","Mitch Marner","TOR","R","69","1006.25","16","29","19","10","45","80.36"
"524","Trevor Moore","L.A","L","82","1116.3666666667","25","20","11","9","45","76.27"
"559","Robert Thomas","STL","C","82","1193.5333333333","14","31","19","12","45","75.00"
"851","Wyatt Johnston","DAL","C","82","1072.7166666667","22","23","18","5","45","86.54"
"120","Brock Nelson","NYI","C","82","1140.9666666667","22","22","15","7","44","80.00"
"296","Max Domi","TOR","C","80","968.01666666667","8","36","23","13","44","67.69"
"488","Jordan Kyrou","STL","C","82","1166.1833333333","22","22","16","6","44","78.57"
"83","Nazem Kadri","CGY","C","82","1159.3666666667","12","31","20","11","43","71.67"
"466","Alex DeBrincat","DET","R","82","1154.6","16","27","17","10","43","67.19"
"546","Casey Mittelstadt","BUF, COL","C","80","1136.8166666667","13","30","15","15","43","63.24"
"548","Nico Hischier","N.J","C","71","957.28333333333","18","25","14","11","43","78.18"
"561","Jason Robertson","DAL","L","82","1186.5666666667","17","26","15","11","43","65.15"
"620","Quinn Hughes","VAN","D","82","1540.6166666667","10","33","13","20","43","46.74"
"770","Lucas Raymond","DET","L","82","1128.45","17","26","17","9","43","75.44"
"787","Tim Stützle","OTT","C","75","1183.2333333333","12","31","13","18","43","74.14"
"9","Evgeni Malkin","PIT","C","82","1157.45","19","23","17","6","42","73.68"
"175","Mark Scheifele","WPG","C","74","1192.5166666667","13","29","20","9","42","71.19"
"188","Jonathan Marchessault","VGK","R","82","1103.4833333333","25","17","13","4","42","77.78"
"261","Jake Guentzel","CAR, PIT","C, L","67","1025.5666666667","19","23","16","7","42","70.00"
"297","Josh Morrissey","WPG","D","81","1605.35","8","34","17","17","42","50.60"
"328","Alex Tuch","BUF","R","75","1054.9666666667","18","24","15","9","42","77.78"
"401","Mathew Barzal","NYI","C","80","1270.2","14","28","24","4","42","67.74"
"783","Alexis Lafrenière","NYR","L","82","1234.3","19","23","16","7","42","60.87"
"61","Roman Josi","NSH","D","82","1543.8","12","29","17","12","41","50.00"
"294","Bo Horvat","NYI","C","81","1201.3166666667","17","24","12","12","41","67.21"
"317","Sam Reinhart","FLA","C","82","1060.9666666667","20","21","14","7","41","70.69"
"397","Travis Konecny","PHI","R","76","1079.2666666667","20","21","16","5","41","71.93"
"436","Conor Garland","VAN","R","82","1003.6666666667","19","22","15","7","41","74.55"
"618","Joel Farabee","PHI","L","82","1091.2","18","23","18","5","41","83.67"
"811","JJ Peterka","BUF","R","82","1135.0833333333","23","18","8","10","41","67.21"
"264","Carter Verhaeghe","FLA","C","76","1034.75","20","20","12","8","40","70.18"
"409","Zach Werenski","CBJ","D","70","1337.7833333333","8","32","15","17","40","50.00"
"573","Cale Makar","COL","D","77","1304.0833333333","11","29","10","19","40","55.56"
"715","Matt Boldy","MIN","L","75","1041.85","18","22","16","6","40","70.18"
"67","Gustav Nyquist","NSH","C","81","1057.4166666667","11","28","19","9","39","69.64"
"79","Matt Duchene","DAL","C","80","1075.65","14","25","16","9","39","72.22"
"126","Vladimir Tarasenko","FLA, OTT","R","76","963.73333333333","17","22","13","9","39","70.91"
"157","Vincent Trocheck","NYR","C","82","1239.6166666667","9","30","22","8","39","60.00"
"353","Devon Toews","COL","D","82","1468.6","10","29","12","17","39","49.37"
"392","Sebastian Aho","CAR","C","78","1074.7833333333","15","24","18","6","39","67.24"
"454","Matthew Tkachuk","FLA","L","80","1035.85","14","25","17","8","39","69.64"
"556","Owen Tippett","PHI","R","78","1012.5333333333","18","21","15","6","39","76.47"
"752","Matias Maccelli","ARI","L","82","1098.4333333333","12","27","15","12","39","76.47"
"135","Tyler Seguin","DAL","C","68","876.23333333333","20","18","7","11","38","77.55"
"160","Blake Coleman","CGY","C","78","1093.2","17","21","7","14","38","76.00"
"287","Aleksander Barkov","FLA","C","73","928.35","13","25","17","8","38","71.70"
"380","Pavel Zacha","BOS","C","78","983.43333333333","13","25","11","14","38","67.86"
"468","Clayton Keller","ARI","R","78","1149.1166666667","19","19","13","6","38","79.17"
"706","Cole Caufield","MTL","R","82","1199.9833333333","16","22","16","6","38","65.52"
"6","Joe Pavelski","DAL","C","82","1085.3166666667","12","25","14","11","37","68.52"
"78","Victor Hedman","T.B","D","78","1358.3166666667","8","29","16","13","37","51.39"
"94","Mattias Ekholm","EDM","D","79","1364.35","8","29","20","9","37","42.05"
"323","Kevin Fiala","L.A","L","82","1144.9666666667","15","22","14","8","37","71.15"
"337","Ivan Barbashev","VGK","C","82","1143.7333333333","15","22","16","6","37","59.68"
"345","Warren Foegele","EDM","L","82","1013.4","17","20","14","6","37","78.72"
"448","Mason Marchment","DAL","L","81","1079.9","15","22","15","7","37","68.52"
"557","Nick Suzuki","MTL","C","82","1239.5166666667","16","21","11","10","37","63.79"
"591","Drake Batherson","OTT","R","82","1173.8166666667","20","17","12","5","37","72.55"
"623","Evan Bouchard","EDM","D","81","1456.9","8","29","10","19","37","39.36"
"776","Seth Jarvis","CAR","C","81","1052.9833333333","14","23","14","9","37","63.79"
"791","Quinton Byfield","L.A","C, R","80","1072.9166666667","12","25","15","10","37","78.72"
"19","Kris Letang","PIT","D","82","1545","9","27","13","14","36","46.15"
"29","Claude Giroux","OTT","R","82","1154.25","14","22","12","10","36","69.23"
"116","Charlie Coyle","BOS","C","82","1035.4","14","22","10","12","36","80.00"
"154","Johnny Gaudreau","CBJ","L","81","1176.3333333333","7","29","22","7","36","60.00"
"398","Dylan Strome","WSH","C","82","1157.35","16","20","14","6","36","75.00"
"400","Brock Boeser","VAN","R","81","1123.0166666667","18","18","13","5","36","59.02"
"477","Trent Frederic","BOS","C","82","1025.7","15","21","13","8","36","78.26"
"644","Noah Dobson","NYI","D","79","1509.2333333333","8","28","16","12","36","50.70"
"704","Nils Hoglander","VAN","L","80","910.8","24","12","8","4","36","69.23"
"77","John Tavares","TOR","C","80","1107.9333333333","15","20","12","8","35","70.00"
"140","Bryan Rust","PIT","R","62","899.9","19","16","9","7","35","58.33"
"168","William Karlsson","VGK","C","70","852.9","19","16","10","6","35","76.09"
"283","Tyler Bertuzzi","TOR","L","80","1117.9166666667","15","20","11","9","35","59.32"
"288","Jonathan Drouin","COL","L","79","1093.35","13","22","11","11","35","52.24"
"302","Anthony Mantha","VGK, WSH","R","74","917.11666666667","20","15","9","6","35","70.00"
"335","Adrian Kempe","L.A","R","77","1007.4166666667","17","18","10","8","35","74.47"
"403","Roope Hintz","DAL","C","80","997.46666666667","14","21","11","10","35","59.32"
"75","Ryan O'Reilly","NSH","C","82","1098.7","11","23","8","15","34","59.65"
"165","Brandon Saad","STL","L","82","1063.5","18","16","7","9","34","72.34"
"382","Jack Eichel","VGK","C","63","847.81666666667","15","19","11","8","34","79.07"
"908","Connor Bedard","CHI","C","68","1043.15","16","18","12","6","34","91.89"
"122","Nick Bjugstad","ARI","C","76","988.03333333333","17","16","9","7","33","63.46"
"184","Phillip Danault","L.A","C","78","1058.2333333333","13","20","14","6","33","64.71"
"333","Jared McCann","SEA","L","80","952.3","16","17","11","6","33","76.74"
"357","Michael Bunting","CAR, PIT","L","81","1013.5166666667","11","22","16","6","33","73.33"
"419","Joel Eriksson Ek","MIN","C","77","996.08333333333","15","18","6","12","33","57.89"
"716","Jack Hughes","N.J","C","62","976.56666666667","13","20","11","9","33","76.74"
"771","Marco Rossi","MIN","C","82","1142.2","18","15","9","6","33","75.00"
"847","Matthew Knies","TOR","L","80","1001.1666666667","15","18","11","7","33","61.11"
"893","Juraj Slafkovsky","MTL","L","82","1175.5833333333","13","20","10","10","33","62.26"
"14","Anze Kopitar","L.A","C","81","1100.05","13","19","11","8","32","62.75"
"53","Steven Stamkos","T.B","C","79","1055.7666666667","14","18","10","8","32","65.31"
"114","Tyler Toffoli","N.J, WPG","C, R","79","1027.7","17","15","10","5","32","58.18"
"130","Jeff Skinner","BUF","L","74","949.08333333333","15","17","11","6","32","68.09"
"291","Sean Monahan","MTL, WPG","C","83","1043.1666666667","14","18","11","7","32","60.38"
"377","Kyle Connor","WPG","L","65","999.61666666667","22","10","4","6","32","74.42"
"502","Filip Hronek","VAN","D","81","1506.85","2","30","11","19","32","37.65"
"567","Martin Necas","CAR","C","77","1083.7833333333","13","19","10","9","32","69.57"
"724","Thomas Harley","DAL","D","79","1419.9666666667","10","22","8","14","32","42.11"
"33","Jamie Benn","DAL","L","82","905.2","13","18","11","7","31","77.50"
"65","Adam Henrique","ANA, EDM","C","82","997.66666666667","15","16","9","7","31","67.39"
"260","Pavel Buchnevich","STL","L","80","1095.5666666667","10","21","10","11","31","62.00"
"325","Dylan Larkin","DET","C","68","954.66666666667","14","17","14","3","31","56.36"
"327","Travis Sanheim","PHI","D","81","1481.75","9","22","11","11","31","54.39"
"330","Nick Schmaltz","ARI","C","79","1142.3833333333","7","24","14","10","31","68.89"
"356","Danton Heinen","BOS","L","74","930.75","14","17","10","7","31","65.96"
"415","Mathieu Joseph","OTT","R","72","981.91666666667","8","23","15","8","31","73.81"
"460","Adam Fox","NYR","D","72","1232.9166666667","9","22","13","9","31","55.36"
"631","Andrei Svechnikov","CAR","R","59","798.5","11","20","11","9","31","83.78"
"675","Yegor Sharangovich","CGY","C","82","1038.25","20","11","6","5","31","75.61"
"58","Erik Karlsson","PIT","D","82","1588.6333333333","6","24","11","13","30","40.00"
"80","Evander Kane","EDM","L","77","1108.1333333333","15","15","9","6","30","68.18"
"87","Chris Kreider","NYR","L","82","1032.9166666667","15","15","7","8","30","58.82"
"89","Reilly Smith","PIT","R","76","999.11666666667","12","18","12","6","30","71.43"
"153","Dylan DeMelo","WPG","D","82","1516.4166666667","3","27","11","16","30","37.04"
"170","Ryan Nugent-Hopkins","EDM","C","80","1081.9833333333","11","19","14","5","30","50.85"
"193","Morgan Rielly","TOR","D","72","1369.4","4","26","16","10","30","38.96"
"252","MacKenzie Weegar","CGY","D","82","1454.45","15","15","7","8","30","46.15"
"263","Anthony Duclair","S.J, T.B","L","73","973.65","19","11","7","4","30","65.22"
"265","Oliver Bjorkstrand","SEA","R","82","1066.3166666667","11","19","11","8","30","73.17"
"276","J.T. Compher","DET","L","77","1030.25","10","20","14","6","30","65.22"
"359","Gustav Forsling","FLA","D","79","1349.2333333333","7","23","15","8","30","43.48"
"374","Frank Vatrano","ANA","R","82","1050.3833333333","17","13","7","6","30","63.83"
"387","Timo Meier","N.J","R","69","990.48333333333","15","15","9","6","30","69.77"
"412","Daniel Sprong","DET","R","76","761.8","14","16","9","7","30","81.08"
"439","Troy Terry","ANA","R","76","1097.55","11","19","12","7","30","69.77"
"492","Pierre-Luc Dubois","L.A","C","82","1061.4","8","22","14","8","30","73.17"
"741","Ilya Mikheyev","VAN","R","78","946.18333333333","11","19","10","9","30","73.17"
"8","Alex Ovechkin","WSH","L","79","1104.3","14","15","11","4","29","70.73"
"74","Kyle Palmieri","NYI","C","82","1073.25","16","13","4","9","29","63.04"
"103","Anders Lee","NYI","L","81","1086.7333333333","13","16","2","14","29","56.86"
"138","Mikael Granlund","S.J","C","69","1007.65","9","20","9","11","29","67.44"
"146","Mark Stone","VGK","R","56","732.8","8","21","9","12","29","76.32"
"225","Jordan Martinook","CAR","L","82","1053.4833333333","12","17","10","7","29","70.73"
"232","Jaccob Slavin","CAR","D","81","1381.8833333333","3","26","9","17","29","45.31"
"241","Alex Kerfoot","ARI","C","82","1027.15","8","21","15","6","29","67.44"
"396","Tommy Novak","NSH","C","71","817.93333333333","10","19","10","9","29","72.50"
"410","Nicolas Roy","VGK","C","70","831.68333333333","9","20","11","9","29","85.29"
"462","Charlie McAvoy","BOS","D","74","1337.2","9","20","7","13","29","43.94"
"499","Tage Thompson","BUF","C","71","953.6","16","13","9","4","29","63.04"
"509","Ross Colton","COL","C","80","933.65","11","18","12","6","29","70.73"
"635","Rasmus Dahlin","BUF","D","81","1609","8","21","13","8","29","45.31"
"762","Drew O'Connor","PIT","L","79","1068.3833333333","13","16","10","6","29","59.18"
"21","Brad Marchand","BOS","L","82","1051.4333333333","15","13","8","5","28","56.00"
"59","Jordan Eberle","SEA","R","78","1086.3666666667","9","19","14","5","28","57.14"
"110","Mats Zuccarello","MIN","R","69","964.3","6","22","14","8","28","62.22"
"186","Rickard Rakell","PIT","R","70","957.26666666667","11","17","5","12","28","53.85"
"273","Jason Dickinson","CHI","C","82","1058.3","19","9","4","5","28","62.22"
"274","Ryan Hartman","MIN","R","74","959.5","12","16","9","7","28","63.64"
"338","Marcus Pettersson","PIT","D","82","1556.4166666667","3","25","8","17","28","32.18"
"373","Andrew Mangiapane","CGY","L","75","1011.3666666667","7","21","14","7","28","59.57"
"375","Noah Hanifin","CGY, VGK","D","80","1452.5333333333","7","21","11","10","28","38.89"
"552","Eeli Tolvanen","SEA","R","81","1034.3833333333","12","16","10","6","28","80.00"
"744","Aliaksei Protas","WSH","C","78","950.16666666667","6","22","12","10","28","66.67"
"768","Connor Zary","CGY","C","63","809.25","13","15","9","6","28","65.12"
"844","Cole Sillinger","CBJ","C","77","987.15","10","18","11","7","28","65.12"
"44","Patrick Kane","DET","R","50","711.28333333333","14","13","7","6","27","81.82"
"47","Mikael Backlund","CGY","C","82","1145.2833333333","10","17","13","4","27","61.36"
"81","Brayden Schenn","STL","C","82","1074.7666666667","11","16","10","6","27","60.00"
"143","Brendan Gallagher","MTL","R","77","925.41666666667","15","12","9","3","27","79.41"
"171","Jonathan Huberdeau","CGY","C","81","1107.9666666667","7","20","13","7","27","65.85"
"185","Vladislav Namestnikov","WPG","C","78","891.48333333333","6","21","11","10","27","60.00"
"217","Chandler Stephenson","VGK","C","75","978.63333333333","8","19","10","9","27","67.50"
"267","Nicholas Paul","T.B","L","82","1056.0833333333","14","13","8","5","27","58.70"
"360","Dakota Joshua","VAN","C","63","746.53333333333","14","13","7","6","27","77.14"
"443","Mason Appleton","WPG","C","82","1138.7333333333","10","17","9","8","27","64.29"
"540","Morgan Geekie","BOS","C","76","1004.0333333333","13","14","7","7","27","61.36"
"566","Miro Heiskanen","DAL","D","71","1360.5666666667","6","21","8","13","27","39.71"
"656","Kirill Marchenko","CBJ","R","78","1019.8666666667","14","13","8","5","27","55.10"
"799","Luke Evangelista","NSH","R","80","917.4","12","15","14","1","27","67.50"
"853","Mason McTavish","ANA","C","64","840.55","12","15","11","4","27","65.85"
"906","Andrei Kuzmenko","CGY, VAN","L","72","815.65","14","13","9","4","27","64.29"
"43","David Perron","DET","L","76","922.06666666667","8","18","9","9","26","68.42"
"139","Nino Niederreiter","WPG","R","77","980.71666666667","12","14","7","7","26","70.27"
"158","Adam Lowry","WPG","C","81","1042.65","9","17","10","7","26","68.42"
"183","Stefan Noesen","CAR","R","81","820.78333333333","11","15","10","5","26","65.00"
"416","Lawson Crouse","ARI","L","81","1008.3333333333","15","11","8","3","26","65.00"
"427","Anthony Cirelli","T.B","C","79","1091.55","10","16","7","9","26","53.06"
"519","Michael Carcone","ARI","L","74","783.61666666667","19","7","3","4","26","68.42"
"542","Michael Rasmussen","DET","C","75","964.15","11","15","10","5","26","65.00"
"562","Morgan Frost","PHI","C","71","880.75","8","18","15","3","26","72.22"
"613","Kiefer Sherwood","NSH","L","68","772.75","10","16","10","6","26","72.22"
"619","Philipp Kurashev","CHI","C","75","1093.8333333333","9","17","12","5","26","76.47"
"622","Ryan McLeod","EDM","C","81","972.33333333333","11","15","13","2","26","66.67"
"700","Dylan Cozens","BUF","C","79","992.91666666667","8","18","14","4","26","61.90"
"784","Dawson Mercer","N.J","C","82","1108.3666666667","16","10","6","4","26","66.67"
"790","Brock Faber","MIN","D","82","1490.9833333333","4","22","13","9","26","39.39"
"792","Alexander Holtz","N.J","R","82","835.58333333333","15","11","6","5","26","81.25"
"825","Yegor Chinakhov","CBJ","R","53","650.56666666667","15","11","7","4","26","78.79"
"876","Logan Cooley","ARI","C","82","1055.8833333333","13","13","11","2","26","65.00"
"909","Zach Benson","BUF","L","71","886.48333333333","10","16","10","6","26","74.29"
"38","James van Riemsdyk","BOS","L","71","768","4","21","13","8","25","83.33"
"52","Drew Doughty","L.A","D","82","1554.5833333333","5","20","10","10","25","41.67"
"149","Ondrej Palat","N.J","L","71","929.85","10","15","9","6","25","62.50"
"174","Mika Zibanejad","NYR","C","81","1060.3666666667","8","17","15","2","25","54.35"
"176","Sean Couturier","PHI","C","74","982.68333333333","5","20","9","11","25","54.35"
"192","Yanni Gourde","SEA","C","80","1133.6666666667","9","16","11","5","25","69.44"
"198","Brady Skjei","CAR","D","80","1361.1333333333","9","16","9","7","25","50.00"
"208","Teuvo Teravainen","CAR","L","76","910.8","14","11","7","4","25","65.79"
"268","Andrew Copp","DET","C","79","1001.0166666667","10","15","8","7","25","54.35"
"292","Darnell Nurse","EDM","D","81","1416.7","7","18","10","8","25","41.67"
"319","Sam Bennett","FLA","C","69","899.41666666667","13","12","8","4","25","55.56"
"342","Ryan Donato","CHI","C","78","915","11","14","9","5","25","75.76"
"421","Jake DeBrusk","BOS","L","80","1012.9666666667","13","12","6","6","25","62.50"
"428","Evan Rodrigues","FLA","C","80","1007","8","17","9","8","25","54.35"
"587","Fabian Zetterlund","S.J","L","82","1195.9333333333","16","9","8","1","25","52.08"
"605","Sean Walker","COL, PHI","D","81","1292.4833333333","8","17","8","9","25","35.21"
"642","Jack McBain","ARI","C","67","714.48333333333","7","18","13","5","25","65.79"
"698","Bowen Byram","BUF, COL","D","73","1274.4166666667","11","14","4","10","25","41.67"
"740","Alex Newhook","MTL","C","55","711.63333333333","12","13","6","7","25","71.43"
"753","Dmitri Voronkov","CBJ","L","75","825.06666666667","11","14","9","5","25","64.10"
"32","Alex Killorn","ANA","C, L","63","902.21666666667","11","13","10","3","24","68.57"
"48","Ryan McDonagh","NSH","D","74","1256.5166666667","2","22","10","12","24","45.28"
"132","Erik Gudbranson","CBJ","D","78","1267.4166666667","6","18","6","12","24","58.54"
"173","Ryan Strome","ANA","C","79","996.66666666667","9","15","6","9","24","63.16"
"295","Valeri Nichushkin","COL","R","54","796","9","15","12","3","24","57.14"
"376","Rasmus Andersson","CGY","D","78","1389.85","5","19","10","9","24","35.29"
"383","Vince Dunn","SEA","D","59","1113.7666666667","6","18","11","7","24","52.17"
"802","Cole Perfetti","WPG","C","71","795.8","11","13","12","1","24","61.54"
"28","Jeff Petry","DET","D","73","1200.2166666667","3","20","8","12","23","42.59"
"30","Jordan Staal","CAR","C","80","993.98333333333","9","14","3","11","23","69.70"
"57","Tyler Myers","VAN","D","77","1221.1","3","20","12","8","23","43.40"
"86","Nick Leddy","STL","D","82","1536.8666666667","2","21","11","10","23","37.70"
"98","David Savard","MTL","D","60","982.13333333333","5","18","6","12","23","46.00"
"102","Erik Haula","N.J","L","76","995.85","11","12","11","1","23","53.49"
"150","Josh Manson","COL","D","76","1173.3833333333","7","16","9","7","23","41.82"
"228","Teddy Blueger","VAN","C","68","831.18333333333","4","19","11","8","23","67.65"
"290","Elias Lindholm","CGY, VAN","C","75","994.41666666667","6","17","7","10","23","58.97"
"355","Sam Lafferty","VAN","C","79","858.3","12","11","4","7","23","71.88"
"371","Darren Raddysh","T.B","D","82","1383.75","4","19","7","12","23","35.94"
"408","Jack Roslovic","CBJ, NYR","C","59","776.13333333333","6","17","9","8","23","62.16"
"422","Ivan Provorov","CBJ","D","82","1393.0833333333","5","18","7","11","23","38.33"
"433","Will Borgen","SEA","D","82","1293.05","3","20","11","9","23","46.94"
"610","Pius Suter","VAN","C","67","807.8","11","12","7","5","23","58.97"
"630","Jesperi Kotkaniemi","CAR","C","79","907.25","10","13","9","4","23","62.16"
"667","Martin Pospisil","CGY","C","63","759.13333333333","8","15","7","8","23","62.16"
"723","Connor McMichael","WSH","C","80","1020.0166666667","13","10","8","2","23","74.19"
"725","Nicholas Robertson","TOR","L","56","584.86666666667","13","10","6","4","23","74.19"
"735","Pavel Dorofeyev","VGK","L","47","570.53333333333","13","10","6","4","23","76.67"
"774","Jake Neighbours","STL","L","77","961.55","18","5","5","0","23","62.16"
"786","Anton Lundell","FLA","C","78","956.5","8","15","7","8","23","67.65"
"806","Tyson Foerster","PHI","R","77","1074.8333333333","14","9","3","6","23","48.94"
"839","Owen Power","BUF","D","76","1388.8166666667","6","17","7","10","23","31.94"
"60","John Carlson","WSH","D","82","1508.4333333333","4","18","5","13","22","40.00"
"73","Marcus Johansson","MIN","L","78","1016.0333333333","9","13","5","8","22","64.71"
"88","Brayden McNabb","VGK","D","82","1356.6833333333","4","18","7","11","22","36.67"
"90","Tomas Tatar","COL, SEA","L","70","791.56666666667","9","13","5","8","22","59.46"
"124","Kevin Hayes","STL","R","79","978.23333333333","12","10","4","6","22","61.11"
"161","Jean-Gabriel Pageau","NYI","C","82","968.96666666667","7","15","10","5","22","64.71"
"164","Boone Jenner","CBJ","C","58","834.13333333333","16","6","2","4","22","56.41"
"178","Jonas Brodin","MIN","D","62","1152.0833333333","5","17","6","11","22","42.31"
"190","Torey Krug","STL","D","77","1291.5166666667","3","19","9","10","22","55.00"
"200","Scott Laughton","PHI","C","82","973.71666666667","9","13","7","6","22","59.46"
"216","Esa Lindell","DAL","D","82","1324.4833333333","4","18","8","10","22","36.67"
"229","Jake McCabe","TOR","D","73","1257.2","5","17","8","9","22","34.92"
"266","Miles Wood","COL","L","74","891.23333333333","5","17","14","3","22","62.86"
"272","Shea Theodore","VGK","D","47","834.1","3","19","12","7","22","55.00"
"298","Alexander Wennberg","NYR, SEA","C","79","1039.0333333333","6","16","9","7","22","48.89"
"350","Michael Amadio","VGK","R","73","892.43333333333","11","11","5","6","22","55.00"
"367","Jake Evans","MTL","C","82","997.21666666667","5","17","8","9","22","64.71"
"447","Jalen Chatfield","CAR","D","72","1036.1","8","14","4","10","22","44.00"
"470","Jakob Chychrun","OTT","D","82","1521.1833333333","7","15","7","8","22","36.07"
"708","Moritz Seider","DET","D","82","1347.5333333333","5","17","9","8","22","34.92"
"819","Artem Zub","OTT","D","69","1196.3333333333","3","19","10","9","22","41.51"
"836","Matty Beniers","SEA","C","77","1094.7","8","14","11","3","22","61.11"
"51","Lars Eller","PIT","C","82","960.18333333333","8","13","5","8","21","63.64"
"66","TJ Brodie","TOR","D","78","1422.85","0","21","8","13","21","30.00"
"113","Jason Zucker","ARI, NSH","L","69","817.36666666667","9","12","8","4","21","65.63"
"203","Mike Matheson","MTL","D","82","1425.3166666667","4","17","8","9","21","42.86"
"218","Shayne Gostisbehere","DET","D","81","1173.5166666667","7","14","8","6","21","50.00"
"301","Curtis Lazar","N.J","C","71","781.43333333333","6","15","10","5","21","63.64"
"442","Vladislav Gavrikov","L.A","D","77","1328.3","5","16","5","11","21","33.87"
"527","Justin Danforth","CBJ","R","71","853.45","8","13","7","6","21","53.85"
"626","Joe Veleno","DET","C","80","937.66666666667","8","13","6","7","21","61.76"
"775","Ridly Greig","OTT","C","72","881.36666666667","9","12","9","3","21","48.84"
"821","Bobby McMann","TOR","C","56","581.93333333333","12","9","3","6","21","72.41"
"838","William Eklund","S.J","L","80","1125.1333333333","5","16","8","8","21","58.33"
"912","Adam Fantilli","CBJ","C","49","613.91666666667","10","11","7","4","21","80.77"
"69","Cameron Atkinson","PHI","R","70","829.68333333333","10","10","3","7","20","68.97"
"92","Dmitry Orlov","CAR","D","82","1274.5833333333","5","15","4","11","20","37.74"
"97","Casey Cizikas","NYI","C","70","801.35","9","11","5","6","20","71.43"
"205","Cody Ceci","EDM","D","79","1326.7","4","16","6","10","20","33.90"
"223","Jimmy Vesey","NYR","L","80","852.5","9","11","6","5","20","83.33"
"227","Colton Sissons","NSH","C","81","944.2","7","13","11","2","20","58.82"
"331","Robby Fabbri","DET","C","68","716.8","13","7","3","4","20","71.43"
"368","Jake Middleton","MIN","D","80","1350.6","5","15","6","9","20","40.00"
"473","Sam Steel","DAL","C","77","860.05","7","13","11","2","20","68.97"
"518","Michael Eyssimont","T.B","C","81","912.75","9","11","7","4","20","58.82"
"536","Mario Ferraro","S.J","D","78","1448.7166666667","3","17","9","8","20","37.74"
"555","Gabriel Vilardi","WPG","C","47","624.85","12","8","7","1","20","55.56"
"572","Ryan Poehling","PHI","C","77","935.48333333333","7","13","9","4","20","62.50"
"576","Alexandre Texier","CBJ","C","78","972.4","8","12","8","4","20","52.63"
"582","Neal Pionk","WPG","D","82","1360.95","4","16","4","12","20","34.48"
"586","Eetu Luostarinen","FLA","C","82","988.5","8","12","7","5","20","64.52"
"597","Nick Perbix","T.B","D","77","1230.15","0","20","9","11","20","35.71"
"627","K'Andre Miller","NYR","D","80","1456.3166666667","7","13","4","9","20","35.71"
"633","Jack Drury","CAR","C","74","790.9","6","14","7","7","20","62.50"
"655","Michael Kesselring","ARI","D","65","986.7","5","15","6","9","20","39.22"
"669","Paul Cotter","VGK","C","76","919.16666666667","5","15","10","5","20","64.52"
"759","Tye Kartye","SEA","L","77","875.21666666667","11","9","4","5","20","71.43"
"804","Alex Laferriere","L.A","R","81","999.95","12","8","4","4","20","60.61"
"27","Cal Clutterbuck","NYI","R","82","798.76666666667","7","12","8","4","19","65.52"
"96","Craig Smith","DAL","C","75","749.03333333333","10","9","4","5","19","67.86"
"105","Nic Dowd","WSH","C","64","791.41666666667","11","8","5","3","19","73.08"
"107","Brenden Dillon","WPG","D","77","1222.9833333333","8","11","3","8","19","35.85"
"181","Joel Armia","MTL","R","66","781.55","14","5","3","2","19","55.88"
"235","Erik Gustafsson","NYR","D","76","1152.0666666667","5","14","8","6","19","41.30"
"326","Sonny Milano","WSH","L","49","557.2","12","7","4","3","19","76.00"
"366","Pierre Engvall","NYI","L","74","1004.7","7","12","8","4","19","52.78"
"386","Jordan Greenway","BUF","L","67","862.48333333333","8","11","5","6","19","52.78"
"445","Matt Roy","L.A","D","81","1390.4333333333","5","14","9","5","19","29.69"
"607","Sean Durzi","ARI","D","76","1294.95","4","15","7","8","19","33.33"
"628","Filip Zadina","S.J","R","72","847.21666666667","10","9","5","4","19","79.17"
"663","Alexander Romanov","NYI","D","81","1480.7833333333","7","12","5","7","19","28.79"
"684","Logan O'Connor","COL","R","57","699.88333333333","9","10","5","5","19","63.33"
"693","Brett Leason","ANA","R","68","704.11666666667","8","11","6","5","19","95.00"
"772","Kaiden Guhle","MTL","D","70","1228.5666666667","4","15","7","8","19","39.58"
"801","Hendrix Lapierre","WSH","C","51","520.81666666667","8","11","3","8","19","90.48"
"833","Janis Moser","ARI","D","80","1323.55","5","14","8","6","19","34.55"
"54","Alex Pietrangelo","VGK","D","64","1095.4","3","15","7","8","18","32.73"
"95","Marcus Foligno","MIN","L","55","635.46666666667","8","10","6","4","18","78.26"
"109","Chris Tanev","CGY, DAL","D","75","1231.4333333333","2","16","7","9","18","32.73"
"119","Justin Faulk","STL","D","60","1070.4833333333","1","17","9","8","18","42.86"
"144","Jesper Fast","CAR","R","73","820.65","6","12","8","4","18","78.26"
"207","Tomas Hertl","S.J, VGK","C","54","791.13333333333","5","13","11","2","18","75.00"
"214","Colton Parayko","STL","D","82","1613.7333333333","8","10","5","5","18","29.51"
"226","Damon Severson","CBJ","D","67","1185.6833333333","7","11","5","6","18","33.33"
"271","Michael McCarron","NSH","R","70","780.41666666667","10","8","5","3","18","56.25"
"281","Artturi Lehkonen","COL","L","45","587.98333333333","6","12","7","5","18","46.15"
"300","Nikita Zadorov","CGY, VAN","D","75","1147.4166666667","6","12","9","3","18","40.91"
"394","Christian Fischer","DET","R","79","820.2","4","14","8","6","18","58.06"
"424","John Marino","N.J","D","75","1271.15","3","15","5","10","18","33.96"
"497","Michael McLeod","N.J","C","45","595.98333333333","9","9","4","5","18","51.43"
"580","Alex Iafallo","WPG","L","82","978.33333333333","9","9","5","4","18","48.65"
"601","Alexey Toropchenko","STL","R","82","920.03333333333","11","7","5","2","18","75.00"
"749","Valtteri Puustinen","PIT","R","52","533.08333333333","5","13","9","4","18","72.00"
"764","Cole Smith","NSH","L","80","898.5","7","11","6","5","18","56.25"
"767","Braden Schneider","NYR","D","82","1181.9833333333","4","14","5","9","18","33.33"
"805","Will Cuylle","NYR","L","81","875.93333333333","11","7","3","4","18","62.07"
"4","Brent Burns","CAR","D","82","1276.6833333333","5","12","5","7","17","26.56"
"10","Blake Wheeler","NYR","R","54","620.53333333333","6","11","4","7","17","65.38"
"22","Nick Foligno","CHI","L","74","969.95","7","10","4","6","17","50.00"
"46","Evgenii Dadonov","DAL","R","51","614.91666666667","10","7","1","6","17","68.00"
"82","Oliver Ekman-Larsson","FLA","D","80","1130.8833333333","7","10","3","7","17","34.69"
"101","Ben Chiarot","DET","D","77","1308.7833333333","4","13","8","5","17","27.87"
"108","Radko Gudas","ANA","D","66","1056.85","6","11","4","7","17","36.96"
"128","Jaden Schwartz","SEA","C","62","825.25","4","13","6","7","17","58.62"
"162","Mike Reilly","FLA, NYI","D","61","913.18333333333","5","12","7","5","17","45.95"
"172","Adam Larsson","SEA","D","81","1530.0666666667","4","13","4","9","17","29.82"
"202","Olli Maatta","DET","D","72","1077.1333333333","4","13","4","9","17","36.96"
"254","Connor Clifton","BUF","D","79","1119.6166666667","3","14","8","6","17","35.42"
"256","Jonny Brodzinski","NYR","C","57","576.28333333333","5","12","4","8","17","73.91"
"332","Kasperi Kapanen","STL","R","73","892.4","3","14","9","5","17","54.84"
"434","Alexandre Carrier","NSH","D","73","1141.35","3","14","6","8","17","36.96"
"455","Joey Anderson","CHI","R","55","669.15","5","12","10","2","17","62.96"
"475","Beck Malenstyn","WSH","L","81","919.11666666667","6","11","8","3","17","53.13"
"710","Cam York","PHI","D","82","1407.1666666667","6","11","3","8","17","32.08"
"712","Bobby Brink","PHI","R","57","642.51666666667","7","10","9","1","17","62.96"
"737","Jordan Spence","L.A","D","71","877.11666666667","1","16","8","8","17","39.53"
"842","Dylan Guenther","ARI","R","45","528.71666666667","7","10","6","4","17","65.38"
"1","Ryan Suter","DAL","D","82","1403.8333333333","2","14","6","8","16","26.23"
"5","Corey Perry","CHI, EDM","R","54","600.26666666667","9","7","4","3","16","53.33"
"24","Kyle Okposo","BUF, FLA","R","67","744.48333333333","8","8","6","2","16","69.57"
"93","Brian Dumoulin","SEA","D","80","1212.2833333333","6","10","4","6","16","41.03"
"111","Calle Jarnkrok","TOR","C","52","615.83333333333","7","9","6","3","16","48.48"
"156","Sean Kuraly","CBJ","C","62","708.56666666667","9","7","5","2","16","64.00"
"194","Hampus Lindholm","BOS","D","73","1304.2","1","15","5","10","16","29.63"
"210","Jacob Trouba","NYR","D","69","1189.95","2","14","6","8","16","36.36"
"236","Josh Anderson","MTL","R","78","1018.9","7","9","6","3","16","44.44"
"340","Nicolas Aube-Kubel","WSH","R","60","714.38333333333","6","10","7","3","16","61.54"
"395","Keegan Kolesar","VGK","R","79","821.15","7","9","6","3","16","66.67"
"414","Thomas Chabot","OTT","D","51","950.53333333333","5","11","5","6","16","34.04"
"461","Ryan Lindgren","NYR","D","76","1222.5666666667","3","13","4","9","16","29.09"
"474","Brett Howden","VGK","C","72","837.93333333333","6","10","8","2","16","50.00"
"545","Mikey Anderson","L.A","D","74","1317.0666666667","2","14","7","7","16","32.00"
"565","Henri Jokiharju","BUF","D","74","1273.85","2","14","8","6","16","27.12"
"569","Dylan Samberg","WPG","D","78","1046.95","1","15","10","5","16","44.44"
"575","Erik Brannstrom","OTT","D","76","1067.65","2","14","6","8","16","42.11"
"660","Pontus Holmberg","TOR","R","54","557.26666666667","7","9","6","3","16","53.33"
"696","Peyton Krebs","BUF","C","80","903.81666666667","4","12","5","7","16","51.61"
"734","Simon Holmstrom","NYI","R","75","855.41666666667","10","6","6","0","16","53.33"
"779","Jack Quinn","BUF","R","27","327.85","8","8","4","4","16","84.21"
"782","Jake Sanderson","OTT","D","79","1274.45","4","12","4","8","16","28.07"
"841","Luke Hughes","N.J","D","82","1369.4","3","13","5","8","16","31.37"
"13","Jack Johnson","COL","D","80","1100.4166666667","3","12","7","5","15","28.85"
"37","Pat Maroon","BOS, MIN","L","51","600.78333333333","4","11","7","4","15","68.18"
"62","Justin Schultz","SEA","D","70","948.81666666667","6","9","3","6","15","60.00"
"72","Mike Hoffman","S.J","C","66","776.1","6","9","3","6","15","71.43"
"85","Dmitry Kulikov","FLA","D","76","1054.6333333333","1","14","9","5","15","37.50"
"206","Tom Wilson","WSH","R","74","980.1","6","9","4","5","15","60.00"
"212","Radek Faksa","DAL","C","74","751.61666666667","5","10","8","2","15","51.72"
"234","Brett Kulak","EDM","D","82","1162.2","3","12","4","8","15","33.33"
"289","Seth Jones","CHI","D","67","1257.7333333333","1","14","8","6","15","34.88"
"307","Conor Sheary","T.B","L","57","588.7","4","11","7","4","15","71.43"
"571","Josh Norris","OTT","C","50","641.08333333333","10","5","1","4","15","57.69"
"581","David Kampf","TOR","C","78","831.13333333333","7","8","3","5","15","57.69"
"593","Noah Cates","PHI","L","59","655.93333333333","5","10","4","6","15","62.50"
"602","Morgan Barron","WPG","C","80","712.78333333333","9","6","3","3","15","60.00"
"647","Rasmus Sandin","WSH","D","68","1268.0833333333","2","13","8","5","15","32.61"
"649","Nils Lundkvist","DAL","D","59","760.66666666667","2","13","9","4","15","38.46"
"658","Connor Dewar","MIN, TOR","C","74","684.23333333333","9","6","4","2","15","71.43"
"713","Kaapo Kakko","NYR","R","61","724.05","10","5","3","2","15","62.50"
"730","Shane Pinto","OTT","C","41","587.01666666667","2","13","6","7","15","62.50"
"835","Kent Johnson","CBJ","C","42","460.38333333333","5","10","6","4","15","71.43"
"886","Pavel Mintyukov","ANA","D","63","933.45","3","12","4","8","15","51.72"
"889","Simon Nemec","N.J","D","60","1016.7166666667","2","13","11","2","15","30.61"
"911","Leo Carlsson","ANA","C","55","788.38333333333","7","8","4","4","15","55.56"
"17","Andrew Cogliano","COL","C","75","615.11666666667","5","9","6","3","14","63.64"
"125","Cam Fowler","ANA","D","81","1405.0666666667","2","12","4","8","14","37.84"
"134","Ryan Johansen","COL","C","63","686.5","8","6","5","1","14","63.64"
"159","Nick Cousins","FLA","C","69","812.23333333333","6","8","2","6","14","60.87"
"204","Zemgus Girgensons","BUF","L","63","669.5","8","6","3","3","14","66.67"
"243","Liam O'Brien","ARI","C","75","705.08333333333","5","9","7","2","14","51.85"
"258","Hudson Fasching","NYI","R","45","527.83333333333","4","10","6","4","14","77.78"
"341","Brandon Montour","FLA","D","66","1158.7666666667","6","8","2","6","14","31.11"
"425","Yakov Trenin","COL, NSH","C","76","935.1","11","3","1","2","14","42.42"
"437","Niko Mikkola","FLA","D","82","1384.2","2","12","4","8","14","28.00"
"479","Max Jones","ANA","L","52","574.7","5","9","8","1","14","73.68"
"491","Samuel Girard","COL","D","59","950.68333333333","1","13","8","5","14","29.79"
"568","Timothy Liljegren","TOR","D","55","887.66666666667","3","11","2","9","14","35.90"
"584","Jan Rutta","S.J","D","69","1117.7166666667","3","11","4","7","14","42.42"
"721","Philip Tomasino","NSH","C","41","440.23333333333","7","7","3","4","14","82.35"
"25","Trevor Lewis","L.A","C","82","792.15","7","6","5","1","13","54.17"
"36","Kevin Shattenkirk","BOS","D","61","838.36666666667","4","9","6","3","13","35.14"
"42","Brendan Smith","N.J","D","63","820.11666666667","5","8","2","6","13","32.50"
"50","Alec Martinez","VGK","D","55","915.93333333333","4","9","5","4","13","30.23"
"76","Jakob Silfverberg","ANA","R","81","780.18333333333","5","8","4","4","13","72.22"
"115","Evgeny Kuznetsov","CAR, WSH","C","63","818.76666666667","5","8","6","2","13","59.09"
"179","Jamie Oleksiak","SEA","D","82","1314.6833333333","2","11","4","7","13","25.49"
"201","Mark Jankowski","NSH","C","32","353.15","6","7","1","6","13","72.22"
"222","Adam Pelech","NYI","D","58","976.81666666667","0","13","8","5","13","32.50"
"269","Ryan Graves","PIT","D","70","1121.1833333333","3","10","3","7","13","34.21"
"280","Justin Bailey","S.J","R","59","615.53333333333","5","8","5","3","13","65.00"
"299","Ryan Pulock","NYI","D","58","1060.9666666667","3","10","3","7","13","28.26"
"308","Trevor van Riemsdyk","WSH","D","70","1163.8166666667","0","13","6","7","13","28.89"
"312","Garnet Hathaway","PHI","R","82","872.93333333333","6","7","5","2","13","48.15"
"399","Brandon Carlo","BOS","D","76","1230.3","3","10","8","2","13","23.64"
"453","Brandon Tanev","SEA","L","66","759.43333333333","6","7","4","3","13","56.52"
"493","Jake Bean","CBJ","D","72","1063","4","9","6","3","13","33.33"
"531","Juuso Valimaki","ARI","D","68","1134.2666666667","2","11","5","6","13","25.00"
"547","Urho Vaakanainen","ANA","D","68","1029.25","1","12","6","6","13","31.71"
"549","Jesper Boqvist","BOS","C","47","500.91666666667","5","8","5","3","13","65.00"
"609","Parker Kelly","OTT","L","80","742.31666666667","4","9","4","5","13","61.90"
"612","Zach Whitecloud","VGK","D","61","954.8","2","11","4","7","13","38.24"
"617","Martin Fehervary","WSH","D","66","1139.1333333333","3","10","3","7","13","36.11"
"650","Jacob Bernard-Docker","OTT","D","72","1008.8666666667","4","9","6","3","13","32.50"
"702","Trevor Zegras","ANA","C","31","416.9","4","9","4","5","13","81.25"
"720","Alex Vlasic","CHI","D","76","1333.6","2","11","3","8","13","26.00"
"788","Lukas Reichel","CHI","L","65","770.76666666667","3","10","7","3","13","76.47"
"891","Matthew Poitras","BOS","C","33","389.1","5","8","3","5","13","76.47"
"18","Marc-Edouard Vlasic","S.J","D","57","826.9","6","6","2","4","12","48.00"
"49","Max Pacioretty","WSH","L","47","571.26666666667","2","10","6","4","12","60.00"
"55","Zach Bogosian","MIN, T.B","D","65","1030.4166666667","3","9","5","4","12","25.00"
"104","Nick Jensen","WSH","D","78","1279.5833333333","1","11","6","5","12","27.27"
"195","Mathew Dumba","ARI, T.B","D","76","1222.0833333333","4","8","1","7","12","26.09"
"239","Connor Brown","EDM","R","71","748.05","4","8","6","2","12","75.00"
"262","Mattias Janmark","EDM","C","71","706.91666666667","4","8","4","4","12","52.17"
"305","Nathan Walker","STL","L","45","469.98333333333","6","6","1","5","12","92.31"
"348","Jake Walman","DET","D","63","993.28333333333","9","3","2","1","12","26.09"
"413","Jeremy Lauzon","NSH","D","79","1230.45","5","7","3","4","12","27.27"
"482","Dante Fabbro","NSH","D","56","813.48333333333","3","9","6","3","12","31.58"
"507","Brandon Duhaime","COL, MIN","R","80","703.56666666667","4","8","7","1","12","46.15"
"513","Michael Pezzetta","MTL","L","61","462.81666666667","3","9","6","3","12","60.00"
"522","Tanner Jeannot","T.B","L","55","607.08333333333","6","6","2","4","12","66.67"
"553","Klim Kostin","DET, S.J","C","52","528.9","7","5","4","1","12","70.59"
"588","Johnathan Kovacevic","MTL","D","62","863.41666666667","6","6","3","3","12","30.77"
"653","Jordan Harris","MTL","D","56","849.08333333333","3","9","6","3","12","36.36"
"16","T.J. Oshie","WSH","R","52","683.91666666667","3","8","3","5","11","55.00"
"35","Ian Cole","VAN","D","78","1204.3333333333","2","9","3","6","11","20.75"
"71","Tyler Johnson","CHI","C","67","812.18333333333","6","5","3","2","11","73.33"
"117","Jon Merrill","MIN","D","65","793.66666666667","4","7","4","3","11","39.29"
"141","Jani Hakanpää","DAL","D","64","954.71666666667","2","9","4","5","11","23.40"
"142","Sam Carrick","ANA, EDM","C","77","698.28333333333","6","5","4","1","11","73.33"
"199","Tanner Pearson","MTL","L","54","574.65","4","7","3","4","11","68.75"
"224","Chris Tierney","N.J","C","52","426.71666666667","3","8","3","5","11","64.71"
"309","Ryan Carpenter","S.J","C","62","594.05","5","6","3","3","11","57.89"
"365","Victor Olofsson","BUF","L","51","508.66666666667","5","6","2","4","11","55.00"
"388","Erik Cernak","T.B","D","69","1076.95","2","9","5","4","11","25.00"
"411","Anthony Beauvillier","CHI, NSH, VAN","L","60","726.91666666667","3","8","4","4","11","50.00"
"456","Luke Kunin","S.J","C","77","966.33333333333","8","3","3","0","11","55.00"
"487","Boris Katchouk","CHI, OTT","L","59","601.55","6","5","2","3","11","73.33"
"496","Nathan Bastian","N.J","R","54","467.03333333333","4","7","3","4","11","73.33"
"501","Alexander Nylander","CBJ, PIT","L","28","384.5","7","4","2","2","11","52.38"
"523","Mathieu Olivier","CBJ","R","54","574.08333333333","4","7","3","4","11","57.89"
"560","MacKenzie Entwistle","CHI","R","67","709.86666666667","5","6","2","4","11","73.33"
"570","Pierre-Olivier Joseph","PIT","D","52","735.7","2","9","5","4","11","33.33"
"590","Emil Bemstrom","CBJ, PIT","C, R","56","545.56666666667","4","7","5","2","11","52.38"
"692","Blake Lizotte","L.A","C","62","612.81666666667","4","7","5","2","11","50.00"
"717","Arthur Kaliyev","L.A","R","51","523.13333333333","4","7","6","1","11","52.38"
"736","Jackson LaCombe","ANA","D","71","1099.6166666667","2","9","6","3","11","35.48"
"785","Justin Barron","MTL","D","48","768.56666666667","5","6","2","4","11","39.29"
"148","Colin Blackwell","CHI","C","44","540.1","6","4","4","0","10","76.92"
"189","Barclay Goodrow","NYR","C","80","822.08333333333","3","7","5","2","10","47.62"
"213","Matt Grzelcyk","BOS","D","63","991.28333333333","1","9","7","2","10","25.00"
"215","Oskar Sundqvist","STL","C","71","731.45","1","9","6","3","10","58.82"
"250","Dominik Kubalik","OTT","L","74","745.81666666667","7","3","3","0","10","62.50"
"316","Aaron Ekblad","FLA","D","51","783.61666666667","3","7","4","3","10","29.41"
"339","Andreas Englund","L.A","D","82","1000.6833333333","1","9","2","7","10","29.41"
"390","A.J. Greer","CGY","L","59","495.01666666667","4","6","3","3","10","71.43"
"432","Kevin Stenlund","FLA","C","81","776.38333333333","7","3","2","1","10","62.50"
"516","Vincent Desharnais","EDM","D","78","1051.9666666667","1","9","0","9","10","34.48"
"532","Kailer Yamamoto","SEA","R","59","566.2","6","4","2","2","10","66.67"
"533","Nicolas Hague","VGK","D","73","1208.1333333333","2","8","2","6","10","21.74"
"544","Cody Glass","NSH","C","41","436.01666666667","5","5","2","3","10","71.43"
"606","Mark Kastelic","OTT","C","63","474.63333333333","5","5","1","4","10","66.67"
"614","Eric Robinson","BUF, CBJ","L","47","506.75","3","7","5","2","10","66.67"
"643","Kevin Bahl","N.J","D","82","1241.55","1","9","5","4","10","16.13"
"651","Jakub Lauko","BOS","C","60","572.48333333333","2","8","6","2","10","62.50"
"673","Scott Perunovich","STL","D","54","684.61666666667","0","10","7","3","10","31.25"
"683","Egor Zamula","PHI","D","66","927.5","2","8","2","6","10","27.03"
"691","Nico Sturm","S.J","C","63","741.76666666667","4","6","5","1","10","45.45"
"714","John Beecher","BOS","C","52","451.63333333333","7","3","3","0","10","71.43"
"828","Mason Lohrei","BOS","D","41","630.46666666667","3","7","2","5","10","37.04"
"843","Logan Stankoven","DAL","C","24","311.56666666667","4","6","4","2","10","52.63"
"868","Arber Xhekaj","MTL","D","44","632.7","3","7","6","1","10","31.25"
"39","Sam Gagner","EDM","C","28","261.55","5","4","3","1","9","90.00"
"155","Nick Seeler","PHI","D","71","1025.4666666667","1","8","6","2","9","18.37"
"191","Luke Glendening","T.B","C","81","737.36666666667","8","1","1","0","9","56.25"
"196","Phillip Di Giuseppe","VAN","L","51","544.75","4","5","3","2","9","56.25"
"240","Ben Hutton","VGK","D","41","596.18333333333","2","7","3","4","9","30.00"
"247","Nate Schmidt","WPG","D","63","888.65","1","8","2","6","9","29.03"
"257","Josh Brown","ARI","D","51","638.55","3","6","3","3","9","27.27"
"285","Brett Pesce","CAR","D","70","1193.85","2","7","1","6","9","19.57"
"352","Fredrik Olofsson","COL","L","57","473.98333333333","3","6","4","2","9","60.00"
"463","Julien Gauthier","NYI","R","27","269.1","5","4","2","2","9","100.00"
"480","Andrew Peeke","BOS, CBJ","D","38","548.36666666667","1","8","5","3","9","37.50"
"489","Taylor Raddysh","CHI","R","73","878.91666666667","3","6","3","3","9","60.00"
"490","Noah Gregor","TOR","C","63","634.48333333333","4","5","5","0","9","56.25"
"495","Mikhail Sergachev","T.B","D","34","586.21666666667","1","8","3","5","9","52.94"
"529","Vinni Lettieri","MIN","C","46","407.15","5","4","3","1","9","69.23"
"585","Gustav Lindstrom","ANA, MTL","D","46","670.93333333333","2","7","5","2","9","32.14"
"632","Ty Emberson","S.J","D","30","498.73333333333","1","8","3","5","9","56.25"
"638","Ty Dellandrea","DAL","C","42","445.3","2","7","4","3","9","50.00"
"678","Rafael Harvey-Pinard","MTL","L","45","458.26666666667","2","7","6","1","9","60.00"
"686","Kyle MacLean","NYI","C","32","317.48333333333","4","5","3","2","9","81.82"
"705","Nikita Okhotiuk","CGY, S.J","D","52","765.76666666667","1","8","4","4","9","39.13"
"729","Jayden Struble","MTL","D","56","856.75","2","7","3","4","9","28.13"
"850","Zack Bolduc","STL","C","25","277.63333333333","5","4","1","3","9","75.00"
"855","Joshua Roy","MTL","R","23","251.53333333333","4","5","4","1","9","75.00"
"2","Jeff Carter","PIT","C","72","664.9","5","3","1","2","8","61.54"
"7","Mark Giordano","TOR","D","46","629.58333333333","3","5","1","4","8","25.00"
"11","Alex Goligoski","MIN","D","36","491.71666666667","0","8","6","2","8","44.44"
"68","Matt Martin","NYI","L","57","523.46666666667","4","4","3","1","8","47.06"
"91","Tyson Barrie","NSH","D","41","603.31666666667","1","7","4","3","8","33.33"
"137","Jarred Tinordi","CHI","D","52","710.66666666667","0","8","5","3","8","42.11"
"152","Travis Boyd","ARI","C","16","148.45","2","6","4","2","8","80.00"
"187","Colin Miller","N.J, WPG","D","46","648.41666666667","4","4","2","2","8","25.00"
"304","Dakota Mermis","MIN","D","47","601.4","3","5","2","3","8","38.10"
"313","Frederick Gaudreau","MIN","C","67","708.21666666667","3","5","2","3","8","53.33"
"354","Viktor Arvidsson","L.A","R","18","228.1","4","4","1","3","8","66.67"
"372","Dryden Hunt","CGY","L","28","303.56666666667","3","5","4","1","8","57.14"
"378","Jonas Siegenthaler","N.J","D","57","949.88333333333","1","7","2","5","8","25.81"
"404","Parker Wotherspoon","BOS","D","41","625.18333333333","0","8","1","7","8","30.77"
"465","Carl Grundstrom","L.A","R","50","521.46666666667","6","2","1","1","8","50.00"
"483","Josh Mahura","FLA","D","30","354.63333333333","0","8","2","6","8","61.54"
"589","Jacob Bryson","BUF","D","36","480.63333333333","1","7","4","3","8","47.06"
"624","Isac Lundestrom","ANA","C","46","526.48333333333","3","5","4","1","8","57.14"
"657","Ilya Lyubushkin","ANA, TOR","D","74","1025.05","0","8","4","4","8","21.62"
"672","Jesse Ylönen","MTL","R","59","515.81666666667","4","4","2","2","8","42.11"
"699","Kaedan Korczak","VGK","D","26","400.71666666667","1","7","3","4","8","40.00"
"742","Joel Kiviranta","COL","L","56","476.41666666667","3","5","3","2","8","47.06"
"751","Zac Jones","NYR","D","31","437.7","1","7","4","3","8","42.11"
"769","Dylan Holloway","EDM","L","38","420.21666666667","5","3","0","3","8","61.54"
"840","Matt Coronato","CGY","R","34","368.28333333333","2","6","4","2","8","57.14"
"880","David Jiricek","CBJ","D","43","604.88333333333","1","7","5","2","8","44.44"
"916","Sam Malinski","COL","D","23","307.9","2","6","1","5","8","50.00"
"3","Zach Parise","COL","L","30","340.61666666667","4","3","1","2","7","70.00"
"64","Marco Scandella","STL","D","65","734.16666666667","1","6","4","2","7","26.92"
"84","Calvin de Haan","T.B","D","59","849.05","2","5","3","2","7","23.33"
"177","Dougie Hamilton","N.J","D","20","349.16666666667","1","6","2","4","7","46.67"
"182","Connor Murphy","CHI","D","46","772.43333333333","1","6","2","4","7","31.82"
"233","Andreas Athanasiou","CHI","C","28","328.3","2","5","3","2","7","70.00"
"251","Kyle Burroughs","S.J","D","73","1259.75","2","5","3","2","7","17.50"
"253","Tyler Motte","T.B","C","69","694.18333333333","4","3","2","1","7","50.00"
"270","Andre Burakovsky","SEA","L","49","578.08333333333","2","5","3","2","7","50.00"
"282","William Carrier","VGK","L","39","429.85","5","2","1","1","7","50.00"
"343","Christian Dvorak","MTL","C","30","374.7","3","4","3","1","7","58.33"
"364","Sammy Blais","STL","L","53","495.76666666667","1","6","5","1","7","70.00"
"393","Oliver Kylington","CGY","D","33","526.46666666667","3","4","1","3","7","33.33"
"407","Noah Juulsen","VAN","D","54","683.78333333333","1","6","3","3","7","28.00"
"423","Dennis Gilbert","CGY","D","34","396","1","6","0","6","7","77.78"
"430","Noel Acciari","PIT","C","55","568.68333333333","4","3","1","2","7","41.18"
"431","Derek Ryan","EDM","C","70","589.16666666667","3","4","3","1","7","63.64"
"504","Troy Stecher","ARI, EDM","D","54","842.11666666667","1","6","3","3","7","20.59"
"525","Alex Barré-Boulet","T.B","C","36","364.46666666667","4","3","2","1","7","63.64"
"535","Conor Timmins","TOR","D","25","348.65","1","6","4","2","7","33.33"
"579","Nick DeSimone","CGY, N.J","D","34","439.75","2","5","1","4","7","35.00"
"594","Sebastian Aho","NYI","D","58","845.73333333333","2","5","1","4","7","28.00"
"652","Calen Addison","MIN, S.J","D","72","1026.45","1","6","2","4","7","25.00"
"665","David Gustafsson","WPG","C","39","326.16666666667","3","4","2","2","7","70.00"
"718","Ryan Johnson","BUF","D","41","547.15","0","7","4","3","7","31.82"
"719","Henry Thrun","S.J","D","51","850.93333333333","1","6","2","4","7","26.92"
"766","Mitchell Chaffee","T.B","R","30","329.31666666667","4","3","1","2","7","58.33"
"817","Alexander Barabanov","S.J","L","46","616.76666666667","4","3","3","0","7","46.67"
"818","Radim Zohorna","PIT","L","33","299.35","4","3","2","1","7","63.64"
"827","Nils Aman","VAN","C","43","380.28333333333","3","4","3","1","7","70.00"
"829","Matthew Kessel","STL","D","39","619.81666666667","1","6","2","4","7","36.84"
"832","Walker Duehr","CGY","R","40","316.35","2","5","4","1","7","53.85"
"834","Josh Doan","ARI","R","11","133.53333333333","5","2","1","1","7","77.78"
"20","Ryan Reaves","TOR","R","49","392.86666666667","4","2","2","0","6","60.00"
"23","Erik Johnson","BUF, PHI","D","67","790.46666666667","5","1","0","1","6","21.43"
"63","Travis Hamonic","OTT","D","48","628.9","2","4","2","2","6","24.00"
"147","Michael Sgarbossa","WSH","C","25","259.26666666667","4","2","2","0","6","75.00"
"166","Joel Edmundson","TOR, WSH","D","53","778.16666666667","1","5","2","3","6","18.75"
"314","Pierre-Edouard Bellemare","SEA","L","40","314.01666666667","3","3","2","1","6","50.00"
"315","Tomas Nosek","N.J","L","36","364.93333333333","2","4","4","0","6","60.00"
"324","Jakub Vrana","STL","L","21","215.96666666667","2","4","2","2","6","66.67"
"363","Kevin Labanc","S.J","R","46","485.05","2","4","2","2","6","66.67"
"384","Travis Dermott","ARI","D","50","707.6","2","4","0","4","6","31.58"
"450","Ryan Lomberg","FLA","L","75","681.46666666667","4","2","2","0","6","35.29"
"471","Dillon Dube","CGY","C","43","416.4","2","4","1","3","6","46.15"
"481","Tyson Jost","BUF","C","43","421.88333333333","3","3","2","1","6","50.00"
"625","Mattias Samuelsson","BUF","D","41","698.48333333333","1","5","1","4","6","21.43"
"646","Adam Boqvist","CBJ","D","35","541.78333333333","1","5","1","4","6","23.08"
"662","Jonatan Berggren","DET","R","12","120.65","2","4","1","3","6","75.00"
"682","Brayden Pachal","CGY, VGK","D","50","670.21666666667","2","4","2","2","6","27.27"
"796","Jamie Drysdale","ANA, PHI","D","34","539.41666666667","2","4","2","2","6","54.55"
"803","Brendan Brisson","VGK","C","15","168.21666666667","1","5","3","2","6","60.00"
"812","Wyatt Kaiser","CHI","D","32","479.4","0","6","0","6","6","35.29"
"814","Isaak Phillips","CHI","D","33","502.71666666667","0","6","3","3","6","54.55"
"861","Olen Zellweger","ANA","D","26","427.31666666667","2","4","2","2","6","54.55"
"881","Kevin Korchinski","CHI","D","76","1297.1166666667","4","2","1","1","6","17.65"
"15","Marc Staal","PHI","D","35","437.38333333333","1","4","2","2","5","31.25"
"34","Nick Bonino","NYR","C","45","444.3","1","4","3","1","5","62.50"
"56","Luke Schenn","NSH","D","63","846.95","1","4","2","2","5","19.23"
"163","Scott Mayfield","NYI","D","41","649.33333333333","0","5","3","2","5","25.00"
"284","Zachary Sanford","ARI, CHI","L","29","293.68333333333","0","5","4","1","5","62.50"
"306","Joel Hanley","CGY, DAL","D","42","556.05","1","4","2","2","5","23.81"
"320","Haydn Fleury","T.B","D","24","354.11666666667","1","4","2","2","5","29.41"
"336","Brendan Lemieux","CAR","L","32","254.38333333333","3","2","2","0","5","45.45"
"503","Jacob MacDonald","S.J","D","34","345.45","4","1","1","0","5","100.00"
"511","Axel Jonsson-Fjallby","WPG","L","26","204.68333333333","2","3","3","0","5","71.43"
"515","Matthew Phillips","PIT, WSH","R","31","280.16666666667","1","4","3","1","5","55.56"
"520","Justin Brazeau","BOS","R","19","199.15","3","2","1","1","5","50.00"
"551","Adam Ruzicka","ARI, CGY","C","42","350.75","3","2","1","1","5","50.00"
"596","Olle Lycksell","PHI","R","18","170","1","4","3","1","5","83.33"
"598","Cole Guttman","CHI","C","27","278.48333333333","2","3","1","2","5","83.33"
"639","Barrett Hayton","ARI","C","33","412.15","2","3","1","2","5","38.46"
"680","Reese Johnson","CHI","C","42","402.65","2","3","0","3","5","50.00"
"685","John Ludvig","PIT","D","33","357.26666666667","3","2","1","1","5","41.67"
"688","Jacob Lucchini","MIN","C","40","352.16666666667","2","3","1","2","5","50.00"
"750","Juuso Parssinen","NSH","C","44","545.51666666667","3","2","0","2","5","35.71"
"830","Daniil Miromanov","CGY, VGK","D","24","426.13333333333","3","2","2","0","5","31.25"
"887","Ivan Miroshnichenko","WSH","L","21","241.2","2","3","1","2","5","71.43"
"99","Nicolas Deslauriers","PHI","L","60","481.46666666667","1","3","1","2","4","44.44"
"112","Justin Holl","DET","D","38","521.31666666667","0","4","1","3","4","14.81"
"118","Tyler Pitlick","NYR","C","34","332.1","1","3","2","1","4","50.00"
"123","Derek Forbort","BOS","D","35","499.51666666667","0","4","1","3","4","17.39"
"127","Austin Watson","T.B","L","33","234.68333333333","2","2","1","1","4","57.14"
"167","Matt Nieto","PIT","L","22","198.63333333333","1","3","3","0","4","50.00"
"197","Brendan Gaunce","CBJ","C","24","265.8","2","2","1","1","4","66.67"
"220","Devin Shore","SEA","C","21","167.85","1","3","2","1","4","44.44"
"248","Chad Ruhwedel","NYR, PIT","D","52","553.91666666667","1","3","1","2","4","26.67"
"255","Carson Soucy","VAN","D","40","592.3","1","3","1","2","4","19.05"
"293","Rasmus Ristolainen","PHI","D","31","452.1","1","3","1","2","4","22.22"
"303","Ross Johnston","ANA","L","68","544.45","1","3","1","2","4","44.44"
"347","Louie Belpedio","PHI","D","12","148.61666666667","2","2","1","1","4","44.44"
"351","William Lagesson","ANA, TOR","D","40","528.91666666667","0","4","1","3","4","23.53"
"358","Max Willman","N.J","C","18","149.51666666667","3","1","0","1","4","80.00"
"391","Jansen Harkins","PIT","C","45","356.95","0","4","4","0","4","66.67"
"406","Caleb Jones","COL","D","25","292.7","0","4","2","2","4","33.33"
"452","Kevin Rooney","CGY","C","33","276.45","3","1","0","1","4","40.00"
"467","Patrik Laine","CBJ","L","18","204.98333333333","3","1","1","0","4","44.44"
"469","Jesse Puljujarvi","PIT","R","22","200.46666666667","3","1","1","0","4","44.44"
"486","Givani Smith","S.J","R","36","280.81666666667","1","3","3","0","4","66.67"
"505","Nikita Zaitsev","CHI","D","38","547.93333333333","1","3","3","0","4","28.57"
"534","Jonah Gadjovich","FLA","L","39","281.81666666667","2","2","2","0","4","57.14"
"578","Filip Chytil","NYR","C","10","136.5","0","4","3","1","4","57.14"
"616","Oliver Wahlstrom","NYI","R","32","326.55","1","3","2","1","4","40.00"
"640","Akil Thomas","L.A","C","7","59.05","3","1","0","1","4","100.00"
"659","Declan Chisholm","MIN, WPG","D","31","425.61666666667","1","3","2","1","4","33.33"
"671","Spencer Stastney","NSH","D","20","273.1","2","2","1","1","4","28.57"
"679","Simon Benoit","TOR","D","64","977.03333333333","0","4","1","3","4","9.09"
"701","Alex Turcotte","L.A","C","20","181.91666666667","1","3","0","3","4","44.44"
"707","Samuel Bolduc","NYI","D","34","429.58333333333","1","3","0","3","4","25.00"
"738","Vladislav Kolyachonok","ARI","D","5","62.283333333333","1","3","1","2","4","57.14"
"794","Thomas Bordeleau","S.J","C","27","312.16666666667","2","2","2","0","4","80.00"
"810","Landon Slaggert","CHI","L","16","166.48333333333","1","3","1","2","4","50.00"
"852","James Malatesta","CBJ","L","11","107.51666666667","2","2","0","2","4","100.00"
"864","Ryker Evans","SEA","D","36","596.36666666667","1","3","3","0","4","22.22"
"867","Emil Lilleberg","T.B","D","37","542.06666666667","0","4","2","2","4","22.22"
"894","Shane Wright","SEA","C","8","89.083333333333","4","0","0","0","4","80.00"
"133","Taylor Hall","CHI","L","10","118.56666666667","2","1","1","0","3","75.00"
"230","Brock McGinn","ANA","L","24","230.6","1","2","0","2","3","50.00"
"231","Dominic Toninato","WPG","C","15","149.15","0","3","2","1","3","50.00"
"238","Vinnie Hinostroza","PIT","C","14","122.11666666667","1","2","1","1","3","100.00"
"244","Kurtis MacDermid","COL, N.J","D, L","45","214.93333333333","2","1","1","0","3","42.86"
"329","Tony DeAngelo","CAR","D","31","347.3","1","2","2","0","3","27.27"
"362","Rourke Chartier","OTT","C","37","322.55","2","1","1","0","3","37.50"
"385","Anthony Richard","BOS","C","9","94.716666666667","1","2","2","0","3","75.00"
"417","Mitchell Stephens","MTL","C","23","180.3","2","1","1","0","3","37.50"
"444","Steven Lorentz","FLA","C","38","313.41666666667","1","2","1","1","3","75.00"
"526","Zack MacEwen","OTT","R","30","189.35","2","1","1","0","3","42.86"
"530","Mason Shaw","MIN","C","20","161.91666666667","1","2","2","0","3","60.00"
"543","Jaret Anderson-Dolan","L.A, NSH","C","31","321.88333333333","0","3","3","0","3","30.00"
"608","Trey Fix-Wolansky","CBJ","R","11","114.5","2","1","1","0","3","50.00"
"611","James Hamblin","EDM","L","31","239.48333333333","2","1","1","0","3","33.33"
"629","Alexander Alexeyev","WSH","D","39","509.2","1","2","1","1","3","20.00"
"641","Liam Foudy","CBJ, NSH","C","13","126.1","0","3","2","1","3","60.00"
"674","Angus Crookshank","OTT","L","13","127.73333333333","2","1","0","1","3","60.00"
"690","Mason Morelli","VGK","L","9","92.1","2","1","0","1","3","100.00"
"728","Jakob Pelletier","CGY","L","13","116.55","1","2","0","2","3","60.00"
"756","Marc Del Gaizo","NSH","D","9","131.26666666667","0","3","0","3","3","37.50"
"760","Louis Crevier","CHI","D","24","345.81666666667","0","3","1","2","3","50.00"
"813","Marat Khusnutdinov","MIN","C","16","179.45","0","3","0","3","3","75.00"
"884","Tristan Luneau","ANA","D","7","114.55","1","2","0","2","3","60.00"
"900","Ben Meyers","ANA, COL","C","23","217.65","1","2","1","1","3","60.00"
"919","Uvis Balinskis","FLA","D","26","339.66666666667","1","2","1","1","3","30.00"
"26","Milan Lucic","BOS","L","4","45.483333333333","0","2","2","0","2","100.00"
"70","Jared Spurgeon","MIN","D","16","243.26666666667","0","2","1","1","2","16.67"
"129","Chris Wagner","COL","R","13","90.166666666667","1","1","1","0","2","50.00"
"145","John Klingberg","TOR","D","14","228.15","0","2","2","0","2","22.22"
"237","Matthew Benning","S.J","D","14","209.15","0","2","2","0","2","50.00"
"242","Jaycob Megna","CHI","D","44","682.18333333333","0","2","0","2","2","10.53"
"275","Adam Erne","EDM","L","24","180.61666666667","1","1","1","0","2","33.33"
"310","Jordan Oesterle","CGY","D","22","287.11666666667","0","2","2","0","2","20.00"
"369","Matthew Highmore","OTT","C","7","44.85","0","2","0","2","2","100.00"
"405","Ethan Bear","WSH","D","24","339.78333333333","0","2","0","2","2","20.00"
"476","Riley Tufte","COL","L","5","53.416666666667","1","1","0","1","2","100.00"
"485","Logan Stanley","WPG","D","25","312.95","1","1","0","1","2","15.38"
"550","Jonas Rondbjerg","VGK","R","20","202.66666666667","0","2","2","0","2","66.67"
"574","Ian Mitchell","BOS","D","13","185.16666666667","0","2","0","2","2","18.18"
"603","Carson Meyer","CBJ","R","14","127.5","1","1","1","0","2","66.67"
"615","Sheldon Rempal","VGK","R","9","85.066666666667","1","1","0","1","2","100.00"
"661","Tyler Tucker","STL","D","26","309.45","1","1","1","0","2","12.50"
"670","Cole Koepke","T.B","L","9","59.416666666667","0","2","1","1","2","66.67"
"681","Jake Christiansen","CBJ","D","12","156.55","0","2","1","1","2","40.00"
"695","Ronnie Attard","PHI","D","12","160.45","0","2","1","1","2","33.33"
"697","Kirby Dach","MTL","C","2","16.433333333333","0","2","0","2","2","100.00"
"709","Nikita Alexandrov","STL","C","23","192.88333333333","0","2","0","2","2","40.00"
"739","Vasily Podkolzin","VAN","R","19","192.18333333333","0","2","1","1","2","40.00"
"748","Santeri Hatakka","N.J","D","12","152.33333333333","0","2","0","2","2","18.18"
"754","Maxwell Crozier","T.B","D","13","166.45","0","2","2","0","2","33.33"
"755","Adam Edstrom","NYR","C","11","91.483333333333","2","0","0","0","2","66.67"
"757","Lukas Rousek","BUF","R","15","156.8","0","2","1","1","2","40.00"
"781","Vasily Ponomarev","CAR","C","2","19.183333333333","1","1","1","0","2","100.00"
"822","Mikael Pyyhtia","CBJ","L","17","198.61666666667","0","2","2","0","2","40.00"
"823","Matt Rempe","NYR","C","17","93.933333333333","1","1","1","0","2","50.00"
"824","Ilya Solovyov","CGY","D","10","143.56666666667","0","2","1","1","2","100.00"
"848","Brandt Clarke","L.A","D","16","179.2","1","1","1","0","2","50.00"
"857","Simon Edvinsson","DET","D","16","265.45","1","1","1","0","2","15.38"
"879","Lane Hutson","MTL","D","2","40.583333333333","0","2","2","0","2","100.00"
"890","Liam Ohgren","MIN","L","4","53","1","1","0","1","2","100.00"
"920","Jiri Smejkal","OTT","L","20","164.31666666667","1","1","1","0","2","100.00"
"31","Nicklas Backstrom","WSH","C","8","96.766666666667","0","1","0","1","1","100.00"
"40","Logan Couture","S.J","C","6","75.083333333333","0","1","1","0","1","100.00"
"100","Byron Froese","VGK","C","16","160.11666666667","0","1","1","0","1","25.00"
"106","Justin Dowling","N.J","C","2","20.266666666667","1","0","0","0","1","100.00"
"136","Dylan McIlrath","WSH","D","3","30.9","0","1","1","0","1","100.00"
"219","Mackenzie MacEachern","STL","L","8","62.566666666667","0","1","0","1","1","50.00"
"278","Nic Petan","MIN","C","6","58.583333333333","0","1","1","0","1","50.00"
"311","Patrick Brown","BOS","C","11","85.233333333333","0","1","0","1","1","50.00"
"349","Mark Friedman","VAN","D","23","273.8","0","1","0","1","1","8.33"
"426","Austin Czarnik","DET","C","34","275.43333333333","0","1","1","0","1","12.50"
"435","Ryan Shea","PIT","D","31","351.66666666667","1","0","0","0","1","8.33"
"464","Brandon Gignac","MTL","C","7","64.6","1","0","0","0","1","100.00"
"472","Kale Clague","BUF","D","3","36.816666666667","0","1","0","1","1","50.00"
"478","William Lockwood","FLA","R","26","203.95","0","1","0","1","1","25.00"
"500","Jacob Moverare","L.A","D","24","234.18333333333","1","0","0","0","1","11.11"
"508","Hardy Haman Aktell","WSH","D","6","63.35","0","1","0","1","1","50.00"
"514","Oskar Steen","BOS","C","34","303.15","1","0","0","0","1","16.67"
"537","Cal Foote","N.J","D","4","53.8","0","1","1","0","1","25.00"
"558","Jack Studnicka","S.J, VAN","C","22","229.53333333333","1","0","0","0","1","33.33"
"563","Max Comtois","CAR","L","1","13.066666666667","0","1","1","0","1","100.00"
"583","Calle Rosen","STL","D","6","73.416666666667","0","1","0","1","1","100.00"
"634","Jonathan Gruden","PIT","C","13","95.066666666667","1","0","0","0","1","100.00"
"637","Rasmus Kupari","WPG","C","28","225.88333333333","0","1","1","0","1","33.33"
"645","Bo Groulx","ANA","C","45","466.71666666667","0","1","0","1","1","20.00"
"648","Adam Ginning","PHI","D","9","117.25","1","0","0","0","1","25.00"
"654","Jan Jenik","ARI","R","5","41.8","0","1","1","0","1","100.00"
"668","Jack St. Ivany","PIT","D","14","162.31666666667","0","1","1","0","1","16.67"
"677","John Leonard","ARI","L","6","40.783333333333","1","0","0","0","1","100.00"
"694","Nolan Foote","N.J","L","4","37.466666666667","1","0","0","0","1","100.00"
"711","Adam Beckman","MIN","L","11","103.13333333333","0","1","1","0","1","100.00"
"731","Philip Broberg","EDM","D","12","120.28333333333","0","1","1","0","1","20.00"
"747","Aku Raty","ARI","R","1","11.75","0","1","0","1","1","100.00"
"758","Nikita Nesterenko","ANA","C","3","34.433333333333","1","0","0","0","1","100.00"
"761","Nikolai Knyzhov","S.J","D","10","150.5","0","1","0","1","1","50.00"
"763","Brandon Biro","BUF","L","5","50.633333333333","1","0","0","0","1","50.00"
"777","Daemon Hunt","MIN","D","12","122.8","0","1","0","1","1","33.33"
"778","Tyler Kleven","OTT","D","9","105.73333333333","0","1","1","0","1","25.00"
"780","Danil Gushchin","S.J","L","4","56.516666666667","1","0","0","0","1","100.00"
"789","Sam Colangelo","ANA","R","3","35.933333333333","1","0","0","0","1","100.00"
"800","Jean-Luc Foudy","COL","C","4","25.666666666667","1","0","0","0","1","100.00"
"807","Roby Jarventie","OTT","L","7","51.616666666667","0","1","0","1","1","100.00"
"849","Logan Mailloux","MTL","D","1","19.433333333333","0","1","0","1","1","50.00"
"860","Nikita Chibrikov","WPG","R","1","7.6666666666667","1","0","0","0","1","100.00"
"872","Marc McLaughlin","BOS","C","1","11.15","1","0","0","0","1","100.00"
"877","Luca Del Bel Belluz","CBJ","C","1","9.5833333333333","1","0","0","0","1","100.00"
"878","Cutter Gauthier","ANA","L","1","15.4","0","1","1","0","1","100.00"
"883","Brad Lambert","WPG","C","1","9.2666666666667","0","1","0","1","1","100.00"
"888","Frank Nazar","CHI","C","3","40.9","1","0","0","0","1","100.00"
"898","Nick Blankenburg","CBJ","D","12","181.9","1","0","0","0","1","10.00"
"901","Milos Kelemen","ARI","L","10","76.416666666667","0","1","0","1","1","50.00"
"902","Adam Klapka","CGY","R","6","40.566666666667","1","0","0","0","1","100.00"
"915","Jason Polin","COL","R","7","51.3","1","0","0","0","1","100.00"
"922","Waltteri Merela","T.B","C","19","170.5","1","0","0","0","1","25.00"
"924","Collin Graf","S.J","R","7","96.616666666667","0","1","0","1","1","50.00"
"41","Riley Nash","NYR","C","1","11.083333333333","0","0","0","0","0","-"
"45","Robert Bortuzzo","NYI, STL","D","27","326.63333333333","0","0","0","0","0","0.00"
"121","Alex Petrovic","DAL","D","1","12.483333333333","0","0","0","0","0","0.00"
"151","Max McCormick","SEA","L","1","5.6333333333333","0","0","0","0","0","-"
"209","Derrick Pouliot","DAL","D","5","59.633333333333","0","0","0","0","0","0.00"
"221","Jujhar Khaira","MIN","L","1","7.2166666666667","0","0","0","0","0","-"
"245","Jayson Megna","BOS","C","1","11.466666666667","0","0","0","0","0","-"
"246","Scott Sabourin","S.J","R","3","27.833333333333","0","0","0","0","0","-"
"249","Anton Blidh","NYR","L","1","5.35","0","0","0","0","0","-"
"259","John Hayden","SEA","C","2","13.45","0","0","0","0","0","-"
"277","Robert Hagg","ANA","D","5","63.133333333333","0","0","0","0","0","-"
"279","Gustav Olofsson","SEA","D","1","14.95","0","0","0","0","0","-"
"344","Justin Kirkland","ARI","C","2","14.45","0","0","0","0","0","-"
"361","Oskar Lindblom","S.J","L","1","11.933333333333","0","0","0","0","0","-"
"370","Bokondji Imama","OTT","L","6","33.516666666667","0","0","0","0","0","0.00"
"379","Colin White","MTL, PIT","C","28","245.33333333333","0","0","0","0","0","0.00"
"402","Glenn Gawdin","ANA","C","1","6.8","0","0","0","0","0","-"
"420","Denis Gurianov","NSH, PHI","R","18","199.73333333333","0","0","0","0","0","0.00"
"440","Adam Gaudette","STL","C","2","19.6","0","0","0","0","0","0.00"
"441","Brett Seney","CHI","L","4","41.05","0","0","0","0","0","0.00"
"446","Samuel Laberge","N.J","L","2","6.0666666666667","0","0","0","0","0","-"
"449","Philippe Myers","T.B","D","5","56","0","0","0","0","0","0.00"
"451","Andrew Poturalski","SEA","C","2","11.866666666667","0","0","0","0","0","-"
"458","Maxime Lajoie","TOR","D","7","81.233333333333","0","0","0","0","0","0.00"
"459","Lucas Johansen","WSH","D","6","81.133333333333","0","0","0","0","0","0.00"
"484","Victor Mete","PHI","D","1","10.866666666667","0","0","0","0","0","-"
"498","Brett Murray","BUF","L","2","15.833333333333","0","0","0","0","0","-"
"506","Rem Pitlick","CHI","C","9","111","0","0","0","0","0","0.00"
"510","Joona Koppanen","PIT","L","4","28.016666666667","0","0","0","0","0","-"
"517","Rhett Gardner","PHI","C","1","7.4666666666667","0","0","0","0","0","-"
"521","Dylan Coghlan","CAR","D","1","16.366666666667","0","0","0","0","0","-"
"528","Zach Aston-Reese","DET","C","3","14.766666666667","0","0","0","0","0","-"
"538","Cale Fleury","SEA","D","1","13.35","0","0","0","0","0","0.00"
"539","Kole Lind","SEA","R","1","5.9833333333333","0","0","0","0","0","-"
"541","Jake Leschyshyn","NYR","C","1","6.4666666666667","0","0","0","0","0","-"
"564","Shane Bowers","N.J","C","8","75.5","0","0","0","0","0","0.00"
"577","Cameron Crotty","ARI","D","1","10.05","0","0","0","0","0","-"
"592","Jacob Peterson","S.J","C","6","66.266666666667","0","0","0","0","0","-"
"595","Marián Studenic","SEA","R","2","15.816666666667","0","0","0","0","0","-"
"599","Sammy Walker","MIN","C","4","36.966666666667","0","0","0","0","0","-"
"600","Philip Kemp","EDM","D","1","2.05","0","0","0","0","0","-"
"604","Grant Hutton","NYI","D","2","17.033333333333","0","0","0","0","0","0.00"
"636","Grigori Denisenko","VGK","L","6","61.216666666667","0","0","0","0","0","0.00"
"664","Ruslan Iskhakov","NYI","C","1","11.666666666667","0","0","0","0","0","-"
"666","Linus Karlsson","VAN","C","4","34.816666666667","0","0","0","0","0","0.00"
"676","Hugh McGing","STL","L","5","40.9","0","0","0","0","0","-"
"687","Samuel Fagemo","L.A, NSH","L","8","63.483333333333","0","0","0","0","0","-"
"689","Joe Snively","WSH","C","3","24.533333333333","0","0","0","0","0","-"
"703","Raphael Lavoie","EDM","C","7","50.983333333333","0","0","0","0","0","-"
"722","Graeme Clarke","N.J","R","3","33.366666666667","0","0","0","0","0","0.00"
"726","Egor Afanasyev","NSH","L","2","22.283333333333","0","0","0","0","0","-"
"727","Sam Poulin","PIT","R","3","23.116666666667","0","0","0","0","0","-"
"732","Victor Soderstrom","ARI","D","3","45.1","0","0","0","0","0","0.00"
"733","Tobias Bjornfot","FLA, L.A, VGK","D","4","55.233333333333","0","0","0","0","0","-"
"743","Cole Schwindt","CGY","R","4","26.95","0","0","0","0","0","-"
"745","Maxence Guenette","OTT","D","7","93.2","0","0","0","0","0","0.00"
"746","Tyler Angle","CBJ","C","2","16.45","0","0","0","0","0","-"
"765","Connor Mackey","NYR","D","1","15.633333333333","0","0","0","0","0","-"
"773","Justin Sourdif","FLA","R","3","26.35","0","0","0","0","0","-"
"793","Emil Andrae","PHI","D","4","50.683333333333","0","0","0","0","0","0.00"
"795","Lukas Cormier","VGK","D","2","28.366666666667","0","0","0","0","0","0.00"
"797","Jack Thompson","S.J, T.B","D","3","44.416666666667","0","0","0","0","0","0.00"
"798","Mavrik Bourque","DAL","C","1","10.316666666667","0","0","0","0","0","-"
"808","Yan Kuznetsov","CGY","D","1","11.966666666667","0","0","0","0","0","-"
"809","Shakir Mukhamadullin","S.J","D","3","54.516666666667","0","0","0","0","0","0.00"
"815","Adam Raska","MIN","R","5","33.65","0","0","0","0","0","0.00"
"816","Gage Goncalves","T.B","C","2","19.916666666667","0","0","0","0","0","-"
"820","Callahan Burke","CAR","C","1","7.1","0","0","0","0","0","-"
"826","Emil Heineman","MTL","L","4","38.266666666667","0","0","0","0","0","0.00"
"831","Alex Steeves","TOR","C","1","9.3333333333333","0","0","0","0","0","-"
"837","Scott Morrow","CAR","D","2","36.283333333333","0","0","0","0","0","0.00"
"845","Oskar Olausson","COL","R","1","11.833333333333","0","0","0","0","0","-"
"846","Mackie Samoskevich","FLA","R","7","79.266666666667","0","0","0","0","0","-"
"854","Brennan Othmann","NYR","L","3","26.016666666667","0","0","0","0","0","-"
"856","Ryan Winterton","SEA","C","9","83.3","0","0","0","0","0","0.00"
"858","Isak Rosen","BUF","R","7","59.1","0","0","0","0","0","-"
"859","Zach Dean","STL","C","9","86.85","0","0","0","0","0","-"
"862","Ethan Del Mastro","CHI","D","2","34.083333333333","0","0","0","0","0","-"
"863","Jackson Blake","CAR","R","1","12.483333333333","0","0","0","0","0","-"
"865","Zack Ostapchuk","OTT","C","7","72.2","0","0","0","0","0","0.00"
"866","Vincent Iorio","WSH","D","6","58.95","0","0","0","0","0","0.00"
"869","Logan Morrison","SEA","C","4","38.116666666667","0","0","0","0","0","-"
"870","Cameron Butler","CBJ","R","1","0.9","0","0","0","0","0","-"
"871","Arshdeep Bains","VAN","L","8","88.166666666667","0","0","0","0","0","-"
"873","Declan Carlile","T.B","D","1","11.45","0","0","0","0","0","0.00"
"874","Marc Johnstone","PIT","R","1","6.15","0","0","0","0","0","-"
"875","Brandon Scanlin","NYR","D","1","10.766666666667","0","0","0","0","0","-"
"882","Jiri Kulich","BUF","C","1","14.283333333333","0","0","0","0","0","-"
"885","Fraser Minten","TOR","C","4","43.85","0","0","0","0","0","0.00"
"892","Matt Savoie","BUF","C","1","3.9166666666667","0","0","0","0","0","-"
"895","Brian Halonen","N.J","L","2","16.4","0","0","0","0","0","-"
"896","Marshall Rifai","TOR","D","2","22.95","0","0","0","0","0","0.00"
"897","Lucas Condotta","MTL","L","3","21.166666666667","0","0","0","0","0","0.00"
"899","Georgii Merkulov","BOS","C","4","40.916666666667","0","0","0","0","0","0.00"
"903","Filip Roos","CHI","D","4","54.166666666667","0","0","0","0","0","0.00"
"904","Pavol Regenda","ANA","L","5","55.4","0","0","0","0","0","-"
"905","Maksymilian Szuber","ARI","D","1","16.85","0","0","0","0","0","-"
"907","Pierrick Dube","WSH","R","3","27.8","0","0","0","0","0","0.00"
"910","Gavin Brindley","CBJ","C","1","10.85","0","0","0","0","0","-"
"913","Bradly Nadeau","CAR","L","1","17.116666666667","0","0","0","0","0","-"
"914","Akito Hirose","VAN","D","3","33.1","0","0","0","0","0","0.00"
"917","Ondrej Pavel","COL","C","2","12.2","0","0","0","0","0","-"
"918","Cole McWard","VAN","D","1","9.0833333333333","0","0","0","0","0","-"
"921","Nikolas Matinpalo","OTT","D","4","27.333333333333","0","0","0","0","0","0.00"
"923","Patrik Koch","ARI","D","1","9.3333333333333","0","0","0","0","0","0.00"