"","Player","Team","Position","GP","TOI","Goals","Total Assists","First Assists","Second Assists","Total Points","IPP"
"292","David Pastrnak","BOS","R","82","1265.8833333333","25","41","30","11","66","91.67"
"141","Nikita Kucherov","T.B","R","78","1263.3166666667","24","37","23","14","61","74.39"
"6","Sidney Crosby","PIT","C","80","1272.8333333333","16","40","23","17","56","76.71"
"456","Brandon Hagel","T.B","L","82","1231.65","23","33","20","13","56","84.85"
"380","Artemi Panarin","NYR","L","80","1238.0166666667","25","30","15","15","55","84.62"
"246","Nathan MacKinnon","COL","C","79","1348.6666666667","15","38","23","15","53","76.81"
"276","Leon Draisaitl","EDM","C","70","1182.3666666667","23","30","20","10","53","81.54"
"500","Jason Robertson","DAL","L","82","1128.95","23","30","15","15","53","85.48"
"330","Kyle Connor","WPG","L","82","1284.4333333333","26","25","14","11","51","77.27"
"334","Connor McDavid","EDM","C","66","1153.4833333333","15","36","23","13","51","75.00"
"371","Mitch Marner","TOR","R","81","1181.5833333333","15","35","19","16","50","80.65"
"673","Aliaksei Protas","WSH","C","76","1055.6833333333","20","30","19","11","50","72.46"
"633","Cole Caufield","MTL","R","82","1142.2333333333","26","23","17","6","49","75.38"
"360","Zach Werenski","CBJ","D","81","1703.4833333333","15","33","21","12","48","55.81"
"499","Robert Thomas","STL","C","70","1032.6","12","36","19","17","48","81.36"
"57","Matt Duchene","DAL","C","82","1105.3833333333","19","28","14","14","47","79.66"
"335","Jack Eichel","VGK","C","77","1149.75","20","27","13","14","47","69.12"
"433","Jordan Kyrou","STL","C, R","82","1157.4166666667","25","22","13","9","47","74.60"
"446","Tage Thompson","BUF","C","76","1083.65","33","14","9","5","47","73.44"
"498","Nick Suzuki","MTL","C","82","1189.1166666667","17","30","16","14","47","65.28"
"147","Mark Scheifele","WPG","C","82","1343.5833333333","19","27","20","7","46","67.65"
"440","Pierre-Luc Dubois","WSH","L","82","1147","13","33","21","12","46","63.01"
"584","Kirill Marchenko","CBJ","R","79","1180.7166666667","24","22","15","7","46","61.33"
"158","Rickard Rakell","PIT","R","81","1256.1333333333","23","22","12","10","45","68.18"
"417","Clayton Keller","UTA","R","81","1166.9166666667","14","31","14","17","45","83.33"
"303","Brayden Point","T.B","C","77","1148.75","21","23","13","10","44","61.11"
"483","Morgan Geekie","BOS","C","77","1116.8833333333","26","18","10","8","44","67.69"
"652","Connor McMichael","WSH","C","82","1112.3166666667","22","22","8","14","44","66.67"
"887","Adam Fantilli","CBJ","C","82","1201.4","25","19","12","7","44","72.13"
"294","Ivan Barbashev","VGK","C","70","1069.9","18","25","18","7","43","69.35"
"279","William Nylander","TOR","R","82","1225.9833333333","24","18","13","5","42","68.85"
"293","Adrian Kempe","L.A","R","81","1119.5333333333","21","21","15","6","42","68.85"
"511","Cale Makar","COL","D","80","1455.6833333333","13","29","19","10","42","57.53"
"697","Dylan Holloway","STL","L","77","1088.4","16","26","17","9","42","72.41"
"740","JJ Peterka","BUF","R","77","1075.8833333333","18","24","13","11","42","59.15"
"55","John Tavares","TOR","C","75","1063.9166666667","20","21","15","6","41","74.55"
"181","Filip Forsberg","NSH","L","82","1153.85","17","24","13","11","41","80.39"
"225","Jake Guentzel","T.B","C","80","1210.8666666667","19","22","11","11","41","56.94"
"299","Ryan Donato","CHI","C","80","1093.5","23","18","15","3","41","85.42"
"350","Travis Konecny","PHI","R","82","1237.9","8","33","20","13","41","89.13"
"442","Jesper Bratt","N.J","L","81","1079.15","12","29","19","10","41","75.93"
"79","Anders Lee","NYI","L","82","1125.7333333333","21","19","11","8","40","66.67"
"94","Brock Nelson","COL, NYI","C","80","1153.7","18","22","13","9","40","71.43"
"286","Alex Tuch","BUF","R","82","1088.4166666667","22","18","8","10","40","72.73"
"302","Warren Foegele","L.A","L","82","1096.8166666667","22","18","8","10","40","74.07"
"713","Alexis Lafrenière","NYR","L","82","1213.8833333333","15","25","18","7","40","64.52"
"901","Matvei Michkov","PHI","R","80","1025.5166666667","15","25","14","11","40","78.43"
"112","Bryan Rust","PIT","R","71","1041.0166666667","20","19","12","7","39","68.42"
"254","Bo Horvat","NYI","C","81","1198.6166666667","16","23","16","7","39","70.91"
"342","Mikko Rantanen","CAR, COL, DAL","R","82","1308.55","12","27","19","8","39","62.90"
"351","Dylan Strome","WSH","C","82","1095.1333333333","19","20","11","9","39","72.22"
"640","Matt Boldy","MIN","L","82","1253.2166666667","14","25","13","12","39","78.00"
"793","Wyatt Johnston","DAL","C","82","1097.4","18","21","13","8","39","69.64"
"828","Logan Cooley","UTA","C","75","1011.05","18","21","12","9","39","72.22"
"4","Alex Ovechkin","WSH","L","65","822.2","21","17","12","5","38","77.55"
"20","Jamie Benn","DAL","L","80","936.68333333333","15","23","14","9","38","76.00"
"224","Pavel Buchnevich","STL","L","76","1089.6333333333","16","22","12","10","38","64.41"
"251","Sean Monahan","CBJ","C","54","742.81666666667","11","27","19","8","38","71.70"
"407","Auston Matthews","TOR","C","67","953.2","15","23","14","9","38","74.51"
"550","Ryan McLeod","BUF","C","79","1027.9","12","26","14","12","38","70.37"
"563","Rasmus Dahlin","BUF","D","73","1358.9833333333","9","29","16","13","38","54.29"
"721","Quinton Byfield","L.A","R","81","1139.8","14","24","10","14","38","65.52"
"861","Juraj Slafkovsky","MTL","L","79","1086.4833333333","13","25","12","13","38","62.30"
"275","Sam Reinhart","FLA","C","79","1122.5666666667","17","20","12","8","37","72.55"
"505","Martin Necas","CAR, COL","C","79","1109.7833333333","12","25","17","8","37","67.27"
"717","Tim Stützle","OTT","C","82","1225.45","14","23","13","10","37","67.27"
"735","Will Cuylle","NYR","L","82","1054.85","16","21","10","11","37","64.91"
"771","Kent Johnson","CBJ","C","68","913.3","19","18","8","10","37","66.07"
"796","Mason McTavish","ANA","C","75","1026.8166666667","14","23","10","13","37","71.15"
"8","Anze Kopitar","L.A","C","81","1132.3833333333","16","20","13","7","36","64.29"
"110","Mikael Granlund","DAL, S.J","C","83","1148.1166666667","11","25","18","7","36","67.92"
"152","J.T. Miller","NYR, VAN","C","72","942.7","11","25","16","9","36","73.47"
"291","Jared McCann","SEA","L","82","980","12","24","16","8","36","69.23"
"378","Anthony Cirelli","T.B","C","80","1137.4166666667","15","21","9","12","36","61.02"
"734","Alex Laferriere","L.A","R","77","1085.5","16","20","14","6","36","65.45"
"906","Macklin Celebrini","S.J","C","70","1057.2833333333","16","20","13","7","36","81.82"
"60","Nazem Kadri","CGY","C","82","1238.4666666667","20","15","10","5","35","81.40"
"127","Vincent Trocheck","NYR","C","82","1231.4666666667","14","21","13","8","35","57.38"
"156","Phillip Danault","L.A","C","80","1094.45","7","28","21","7","35","67.31"
"355","Roope Hintz","DAL","C","76","907.88333333333","17","18","13","5","35","74.47"
"390","Troy Terry","ANA","R","76","1120.7","14","21","9","12","35","76.09"
"548","Quinn Hughes","VAN","D","68","1363.4","10","25","17","8","35","53.85"
"637","Bobby Brink","PHI","R","79","968.35","9","26","13","13","35","79.55"
"699","Marco Rossi","MIN","C","82","1222.65","14","21","14","7","35","62.50"
"788","Matthew Knies","TOR","L","78","1086.3166666667","22","13","6","7","35","64.81"
"881","Connor Bedard","CHI","C","82","1344.5833333333","11","24","21","3","35","68.63"
"177","Tom Wilson","WSH","R","81","1085.8166666667","16","18","11","7","34","55.74"
"288","Nick Schmaltz","UTA","C","82","1137.55","11","23","9","14","34","69.39"
"359","Jack Roslovic","CAR","C","81","971.63333333333","19","15","8","7","34","73.91"
"414","Alex DeBrincat","DET","R","82","1145.7166666667","22","12","7","5","34","70.83"
"716","Anton Lundell","FLA","C","79","992.41666666667","11","23","17","6","34","77.27"
"830","Cutter Gauthier","ANA","L","81","991.93333333333","15","19","11","8","34","68.00"
"40","Erik Karlsson","PIT","D","82","1547.8666666667","8","25","8","17","33","42.86"
"90","Tyler Toffoli","S.J","C","78","1004.3","20","13","10","3","33","78.57"
"102","Jaden Schwartz","SEA","C","81","1162.4166666667","17","16","8","8","33","64.71"
"148","Sean Couturier","PHI","C","79","1153.2666666667","11","22","13","9","33","60.00"
"247","Aleksander Barkov","FLA","C","67","935.53333333333","7","26","17","9","33","80.49"
"283","Dylan Larkin","DET","C","82","1188.4666666667","12","21","15","6","33","64.71"
"340","Timo Meier","N.J","R","80","1202.85","16","17","7","10","33","68.75"
"366","Thomas Chabot","OTT","D","80","1443.9166666667","7","26","14","12","33","50.00"
"408","Adam Fox","NYR","D","74","1265.2666666667","6","27","17","10","33","49.25"
"496","Gabriel Vilardi","WPG","C","71","1052.1833333333","13","20","12","8","33","60.00"
"542","Kiefer Sherwood","VAN","L","78","943.48333333333","15","18","11","7","33","68.75"
"551","Evan Bouchard","EDM","D","81","1524.0166666667","10","23","6","17","33","46.48"
"624","Bowen Byram","BUF","D","82","1507.1166666667","7","26","12","14","33","41.25"
"627","Dylan Cozens","BUF, OTT","C","82","1060.7","11","22","16","6","33","63.46"
"638","Kaapo Kakko","NYR, SEA","R","79","1061.6166666667","9","24","16","8","33","68.75"
"642","Jack Hughes","N.J","C","62","951.45","16","17","13","4","33","66.00"
"679","Dmitri Voronkov","CBJ","L","73","1035.5166666667","14","19","11","8","33","51.56"
"698","Lucas Raymond","DET","L","82","1123.3166666667","16","17","11","6","33","73.33"
"775","William Eklund","S.J","L","77","1106.7833333333","9","24","17","7","33","63.46"
"834","Lane Hutson","MTL","D","82","1512.9333333333","5","28","11","17","33","44.59"
"23","James van Riemsdyk","CBJ","L","71","803.23333333333","13","19","10","9","32","71.11"
"53","Kyle Palmieri","NYI","C","82","1150.95","17","15","8","7","32","62.75"
"56","Victor Hedman","T.B","D","79","1366.5333333333","11","21","14","7","32","45.71"
"58","Brayden Schenn","STL","C","82","1141.8666666667","9","23","13","10","32","60.38"
"228","Carter Verhaeghe","FLA","C","81","1148.2666666667","14","18","11","7","32","61.54"
"242","Artturi Lehkonen","COL","L","69","1098.6833333333","21","11","7","4","32","50.00"
"308","Devon Toews","COL","D","76","1503.8","7","25","8","17","32","46.38"
"490","Nico Hischier","N.J","C","75","1072.75","19","13","9","4","32","71.11"
"663","Pavel Dorofeyev","VGK","L","82","1124.2333333333","21","11","5","6","32","64.00"
"894","Will Smith","S.J","C","74","958.16666666667","12","20","16","4","32","69.57"
"86","Mats Zuccarello","MIN","R","69","1057.6833333333","13","18","12","6","31","67.39"
"118","Mark Stone","VGK","R","66","952.65","12","19","13","6","31","64.58"
"145","Ryan Strome","ANA","C","81","1077.3833333333","9","22","17","5","31","64.58"
"146","Mika Zibanejad","NYR","C","82","1044.4166666667","11","20","14","6","31","72.09"
"178","Tomas Hertl","VGK","C","73","986.43333333333","13","18","11","7","31","77.50"
"229","Oliver Bjorkstrand","SEA, T.B","R","79","966.78333333333","16","15","12","3","31","72.09"
"281","Kevin Fiala","L.A","L","81","1180.5","18","13","11","2","31","64.58"
"327","Frank Vatrano","ANA","R","80","1065.9166666667","14","17","4","13","31","67.39"
"333","Pavel Zacha","BOS","C","82","1116.1333333333","8","23","13","10","31","58.49"
"389","Kirill Kaprizov","MIN","L","41","725.01666666667","12","19","13","6","31","81.58"
"523","Fabian Zetterlund","OTT, S.J","L","84","1145.8166666667","12","19","12","7","31","60.78"
"527","Drake Batherson","OTT","R","82","1117.65","11","20","13","7","31","79.49"
"559","Jesperi Kotkaniemi","CAR","C","78","965.48333333333","11","20","9","11","31","63.27"
"702","Jake Neighbours","STL","L","82","1061.35","14","17","12","5","31","67.39"
"705","Seth Jarvis","CAR","C","73","956.45","13","18","11","7","31","73.81"
"736","Tyson Foerster","PHI","R","81","1071.3","16","15","7","8","31","70.45"
"863","Shane Wright","SEA","C","79","916.43333333333","12","19","12","7","31","63.27"
"913","Maxim Tsyplakov","NYI","R","77","1011.75","8","23","12","11","31","70.45"
"42","John Carlson","WSH","D","79","1292.5833333333","3","27","14","13","30","46.15"
"105","Zach Hyman","EDM","L","72","1079.2333333333","19","11","8","3","30","49.18"
"107","Taylor Hall","CAR, CHI","L","77","997.56666666667","11","19","12","7","30","69.77"
"143","Jonathan Huberdeau","CGY","C, L","81","1147.3333333333","13","17","13","4","30","63.83"
"257","Josh Morrissey","WPG","D","80","1565.9166666667","9","21","9","12","30","46.15"
"277","Sam Bennett","FLA","C","76","1051.6166666667","14","16","10","6","30","68.18"
"280","Nikolaj Ehlers","WPG","L","69","857.55","14","16","8","8","30","78.95"
"345","Sebastian Aho","CAR","C","79","1074.05","13","17","13","4","30","58.82"
"397","Mason Marchment","DAL","L","62","802.63333333333","14","16","12","4","30","73.17"
"543","Eric Robinson","CAR","L","82","933.63333333333","12","18","14","4","30","58.82"
"662","Simon Holmstrom","NYI","R","75","965.06666666667","13","17","12","5","30","62.50"
"89","Jason Zucker","BUF","L","73","909.81666666667","9","20","15","5","29","58.00"
"132","Jean-Gabriel Pageau","NYI","C","79","1011.4333333333","11","18","9","9","29","67.44"
"231","Nick Paul","T.B","L","76","1073.7833333333","15","14","8","6","29","67.44"
"236","Shea Theodore","VGK","D","67","1225.15","4","25","13","12","29","53.70"
"466","Mathieu Olivier","CBJ","R","82","1060.1166666667","16","13","6","7","29","69.05"
"467","Trevor Moore","L.A","L","71","933.9","10","19","7","12","29","65.91"
"497","Owen Tippett","PHI","R","77","1003.4333333333","18","11","8","3","29","65.91"
"540","Pius Suter","VAN","C","81","1029.0166666667","18","11","5","6","29","64.44"
"653","Thomas Harley","DAL","D","78","1427.2666666667","11","18","7","11","29","37.18"
"18","Jordan Staal","CAR","C","75","944.03333333333","11","17","12","5","28","73.68"
"54","Ryan O'Reilly","NSH","C","79","1096.05","8","20","10","10","28","65.12"
"187","Chandler Stephenson","SEA","C","78","1066.95","10","18","11","7","28","62.22"
"192","Jordan Martinook","CAR","L","79","1004.5666666667","12","16","11","5","28","70.00"
"421","Brett Howden","VGK","C","80","1055.0333333333","16","12","7","5","28","59.57"
"528","Noah Cates","PHI","L","78","982.65","14","14","9","5","28","68.29"
"732","Cole Perfetti","WPG","C","82","1069.0833333333","10","18","11","7","28","66.67"
"776","Owen Power","BUF","D","79","1341.5","5","23","9","14","28","45.16"
"885","Leo Carlsson","ANA","C","75","949.71666666667","12","16","6","10","28","80.00"
"5","Evgeni Malkin","PIT","C","68","981.55","10","17","12","5","27","71.05"
"28","Evgenii Dadonov","DAL","R","80","980.2","13","14","8","6","27","56.25"
"115","Brendan Gallagher","MTL","R","82","990.51666666667","12","15","9","6","27","69.23"
"160","Jonathan Marchessault","NSH","R","78","1069.4833333333","14","13","6","7","27","72.97"
"163","Yanni Gourde","SEA, T.B","C","57","794.01666666667","5","22","10","12","27","75.00"
"179","Teuvo Teravainen","CHI","C","82","1038.75","6","21","13","8","27","69.23"
"184","Colton Parayko","STL","D","64","1265.3","13","14","4","10","27","43.55"
"234","Andre Burakovsky","SEA","L","79","975.16666666667","10","17","12","5","27","62.79"
"295","Marcus Pettersson","PIT, VAN","D","78","1425.7333333333","4","23","12","11","27","36.00"
"324","Darren Raddysh","T.B","D","73","1088.2","4","23","9","14","27","50.00"
"348","Keegan Kolesar","VGK","R","82","1032.0166666667","11","16","7","9","27","69.23"
"404","Matthew Tkachuk","FLA","L","52","715.66666666667","8","19","13","6","27","71.05"
"664","Jackson LaCombe","ANA","D","74","1240.1166666667","10","17","10","7","27","52.94"
"670","Ilya Mikheyev","CHI","R","80","1048.85","14","13","6","7","27","57.45"
"751","Bobby McMann","TOR","C","74","958.73333333333","16","11","7","4","27","56.25"
"773","Matty Beniers","SEA","C","82","1195.35","13","14","9","5","27","58.70"
"837","Marco Kasper","DET","C","77","1012.9166666667","13","14","5","9","27","75.00"
"13","Nick Foligno","CHI","L","78","983.38333333333","10","16","8","8","26","68.42"
"26","Patrick Kane","DET","R","72","1010.6333333333","8","18","9","9","26","74.29"
"66","Reilly Smith","NYR, VGK","R","79","981.81666666667","7","19","12","7","26","61.90"
"99","Cam Fowler","ANA, STL","D","68","1199.6166666667","6","20","13","7","26","41.27"
"131","Blake Coleman","CGY","C, L","82","1127.6833333333","7","19","12","7","26","68.42"
"137","Brandon Saad","STL, VGK","L","72","940.25","13","13","6","7","26","66.67"
"206","Connor Brown","EDM","R","81","974.75","10","16","7","9","26","72.22"
"328","Noah Hanifin","VGK","D","80","1482.4666666667","7","19","10","9","26","37.14"
"353","Brock Boeser","VAN","R","75","1034.8333333333","15","11","6","5","26","72.22"
"419","Jakob Chychrun","WSH","D","74","1297.7666666667","13","13","6","7","26","41.94"
"436","Taylor Raddysh","WSH","R","80","934.61666666667","7","19","7","12","26","68.42"
"493","Eeli Tolvanen","SEA","R","81","1023.65","17","9","2","7","26","63.41"
"568","Barrett Hayton","UTA","C","82","1028.1333333333","11","15","7","8","26","66.67"
"782","Logan Stankoven","CAR, DAL","C","78","991.75","10","16","7","9","26","63.41"
"811","Jackson Blake","CAR","R","80","912.56666666667","12","14","10","4","26","68.42"
"35","Steven Stamkos","NSH","C","82","1118.5166666667","11","14","12","2","25","62.50"
"69","Dmitry Orlov","CAR","D","76","1314.1666666667","5","20","7","13","25","43.86"
"171","Scott Laughton","PHI, TOR","C","80","969.28333333333","8","17","11","6","25","78.13"
"250","Elias Lindholm","BOS","C","82","1012.3833333333","11","14","7","7","25","54.35"
"256","Max Domi","TOR","C","74","912.68333333333","8","17","14","3","25","62.50"
"300","Christian Dvorak","MTL","C","82","990.45","10","15","9","6","25","73.53"
"304","Jake Walman","EDM, S.J","D","65","1088.6","6","19","7","12","25","43.86"
"311","Danton Heinen","PIT, VAN","L","79","914.38333333333","7","18","9","9","25","67.57"
"373","Jake DeBrusk","VAN","L","82","1061.55","11","14","5","9","25","56.82"
"488","Casey Mittelstadt","BOS, COL","C","81","1133.0666666667","11","14","9","5","25","55.56"
"510","Ryan Poehling","PHI","C","68","795.58333333333","10","15","9","6","25","75.76"
"583","Michael Kesselring","UTA","D","82","1309.6666666667","5","20","14","6","25","52.08"
"629","Trevor Zegras","ANA","C","56","779.96666666667","8","17","10","7","25","78.13"
"778","Luke Hughes","N.J","D","71","1283","6","19","12","7","25","58.14"
"780","Dylan Guenther","UTA","R","70","870.06666666667","11","14","8","6","25","62.50"
"12","Brad Marchand","BOS, FLA","L","71","906.4","11","13","9","4","24","75.00"
"19","Alex Killorn","ANA","L","81","1039.7","12","12","8","4","24","55.81"
"36","Alex Pietrangelo","VGK","D","71","1298.8333333333","2","22","11","11","24","42.11"
"59","Oliver Ekman-Larsson","TOR","D","77","1352.9833333333","2","22","7","15","24","40.00"
"91","Charlie Coyle","BOS, COL","C","83","1031.7","13","11","7","4","24","61.54"
"104","Jeff Skinner","EDM","C, L","72","829.68333333333","14","10","7","3","24","72.73"
"183","Matt Grzelcyk","PIT","D","82","1424.4166666667","1","23","12","11","24","38.10"
"195","Teddy Blueger","VAN","C","82","967.75","6","18","11","7","24","72.73"
"244","Tyler Bertuzzi","CHI","L","82","1063.65","11","13","8","5","24","66.67"
"298","Brandon Montour","SEA","D","81","1527.0166666667","10","14","6","8","24","42.86"
"361","Nicolas Roy","VGK","C","71","909.86666666667","13","11","4","7","24","77.42"
"387","Conor Garland","VAN","R","81","1098.2666666667","8","16","11","5","24","82.76"
"392","Vladislav Gavrikov","L.A","D","82","1534.9666666667","4","20","8","12","24","39.34"
"429","Dante Fabbro","CBJ, NSH","D","68","1273.3","8","16","5","11","24","37.50"
"443","Mikhail Sergachev","UTA","D","77","1341.4166666667","9","15","9","6","24","38.71"
"549","Brady Tkachuk","OTT","L","72","984.6","11","13","6","7","24","66.67"
"573","Noah Dobson","NYI","D","71","1298.6666666667","8","16","9","7","24","46.15"
"622","Peyton Krebs","BUF","C","81","1008.6166666667","7","17","7","10","24","57.14"
"668","Vasily Podkolzin","EDM","R","81","1007.9666666667","8","16","6","10","24","61.54"
"708","Jack Quinn","BUF","R","74","892.76666666667","11","13","6","7","24","63.16"
"714","Dawson Mercer","N.J","C","82","1113.2166666667","11","13","9","4","24","61.54"
"792","Zack Bolduc","STL","C, R","72","803.66666666667","12","12","4","8","24","61.54"
"801","Simon Edvinsson","DET","D","78","1424","4","20","11","9","24","43.64"
"17","Claude Giroux","OTT","R","81","1007.6333333333","7","16","9","7","23","62.16"
"72","Marcus Foligno","MIN","L","77","940.53333333333","9","14","8","6","23","62.16"
"129","Adam Lowry","WPG","C","73","929.06666666667","13","10","2","8","23","67.65"
"155","Stefan Noesen","N.J","R","78","978.8","8","15","12","3","23","58.97"
"208","Alexander Kerfoot","UTA","C","81","968.51666666667","9","14","10","4","23","76.67"
"239","J.T. Compher","DET","L","76","979.5","6","17","9","8","23","76.67"
"252","Darnell Nurse","EDM","D","75","1428.4333333333","3","20","12","8","23","36.51"
"272","Frederick Gaudreau","MIN","C","82","1007.6666666667","10","13","9","4","23","69.70"
"313","Gustav Forsling","FLA","D","80","1490.7","7","16","9","7","23","34.85"
"379","Evan Rodrigues","FLA","C","82","1091.8166666667","11","12","5","7","23","53.49"
"383","Kevin Stenlund","UTA","C","82","926.41666666667","10","13","7","6","23","67.65"
"391","Adam Gaudette","OTT","R","81","717.01666666667","16","7","4","3","23","71.88"
"395","Matt Roy","WSH","D","69","1193.5333333333","3","20","12","8","23","41.07"
"495","Elias Pettersson","VAN","C","64","875.08333333333","7","16","8","8","23","67.65"
"571","Jack McBain","UTA","C","82","948.43333333333","11","12","7","5","23","60.53"
"628","Alex Turcotte","L.A","C","68","736.31666666667","8","15","10","5","23","69.70"
"631","Nils Hoglander","VAN","L","72","813","7","16","9","7","23","63.89"
"659","Shane Pinto","OTT","C","70","939.7","13","10","6","4","23","62.16"
"660","Philip Broberg","STL","D","68","1210.0166666667","7","16","8","8","23","47.92"
"730","Luke Evangelista","NSH","R","68","832.85","5","18","9","9","23","79.31"
"777","Matt Coronato","CGY","R","77","1090.2","15","8","7","1","23","57.50"
"877","Andrei Kuzmenko","CGY, L.A, PHI","L","66","825.05","7","16","7","9","23","65.71"
"882","Zach Benson","BUF","L","75","909.26666666667","6","17","13","4","23","54.76"
"2","Brent Burns","CAR","D","82","1293.4","6","16","8","8","22","36.07"
"30","Ryan McDonagh","T.B","D","82","1374.4666666667","2","20","9","11","22","32.84"
"100","Vladimir Tarasenko","DET","R","80","1007.7166666667","9","13","9","4","22","57.89"
"111","Nino Niederreiter","WPG","R","82","1082.5166666667","10","12","8","4","22","51.16"
"149","Dougie Hamilton","N.J","D","64","1003.2166666667","4","18","7","11","22","40.74"
"170","Tanner Pearson","VGK","L","78","891.88333333333","8","14","8","6","22","70.97"
"193","Damon Severson","CBJ","D","70","1164.6833333333","5","17","11","6","22","38.60"
"248","Jonathan Drouin","COL","L","43","606.11666666667","7","15","9","6","22","59.46"
"258","Alexander Wennberg","S.J","C","77","1018.6666666667","5","17","10","7","22","56.41"
"336","Vince Dunn","SEA","D","62","1114.0166666667","6","16","8","8","22","34.92"
"362","Anthony Beauvillier","PIT, WSH","L","81","989.05","14","8","3","5","22","55.00"
"449","Filip Hronek","VAN","D","61","1132.3","5","17","8","9","22","40.00"
"520","Neal Pionk","WPG","D","69","1236.2833333333","5","17","12","5","22","41.51"
"555","K'Andre Miller","NYR","D","74","1339.7833333333","7","15","10","5","22","35.48"
"665","Jordan Spence","L.A","D","79","1146.85","4","18","8","10","22","41.51"
"790","Brandt Clarke","L.A","D","78","1090.35","3","19","11","8","22","37.93"
"841","Jiri Kulich","BUF","C","62","774.06666666667","14","8","5","3","22","53.66"
"52","Marcus Johansson","MIN","L","72","1021.5166666667","7","14","12","2","21","65.63"
"121","Ondrej Palat","N.J","L","77","943.53333333333","11","10","4","6","21","55.26"
"142","Ryan Nugent-Hopkins","EDM","C","77","1016.5333333333","9","12","10","2","21","50.00"
"144","Adam Larsson","SEA","D","82","1446.6666666667","4","17","8","9","21","28.38"
"157","Vladislav Namestnikov","WPG","C","78","981","7","14","5","9","21","55.26"
"176","Cody Ceci","DAL, S.J","D","85","1525.55","4","17","5","12","21","29.17"
"196","Jake McCabe","TOR","D","66","1161.95","2","19","9","10","21","35.59"
"201","Brett Kulak","EDM","D","81","1475.5333333333","6","15","4","11","21","39.62"
"203","Josh Anderson","MTL","R","81","990.21666666667","12","9","5","4","21","60.00"
"216","MacKenzie Weegar","CGY","D","81","1471.4833333333","3","18","6","12","21","34.43"
"317","Victor Olofsson","VGK","L","56","714.91666666667","9","12","10","2","21","60.00"
"319","Jake Evans","MTL","C","82","977.1","7","14","11","3","21","65.63"
"374","Ivan Provorov","CBJ","D","82","1534.9666666667","5","16","5","11","21","29.17"
"388","Niko Mikkola","FLA","D","76","1330.5333333333","6","15","3","12","21","40.38"
"491","Jesper Boqvist","FLA","C","78","913.51666666667","10","11","6","5","21","63.64"
"501","Morgan Frost","CGY, PHI","C","81","1009.8666666667","11","10","4","6","21","58.33"
"575","Rasmus Sandin","WSH","D","82","1401.35","2","19","11","8","21","29.58"
"784","Cole Sillinger","CBJ","C","66","873.56666666667","6","15","9","6","21","60.00"
"29","Mikael Backlund","CGY","C","76","1050.6","12","8","5","3","20","57.14"
"306","Michael Amadio","OTT","R","72","918.46666666667","7","13","11","2","20","58.82"
"309","Viktor Arvidsson","EDM","L","66","880.13333333333","11","9","6","3","20","62.50"
"326","Andrew Mangiapane","WSH","L","81","924.38333333333","11","9","6","3","20","71.43"
"385","Alexandre Carrier","MTL, NSH","D","79","1394.8333333333","3","17","9","8","20","38.46"
"420","Sam Steel","DAL","C","79","922.53333333333","5","15","8","7","20","83.33"
"439","Samuel Girard","COL","D","73","1307.9833333333","2","18","9","9","20","33.90"
"454","Ross Colton","COL","C","61","747.3","9","11","7","4","20","71.43"
"487","Mikey Anderson","L.A","D","77","1427.5","3","17","6","11","20","42.55"
"560","Andrei Svechnikov","CAR","R","72","932.1","5","15","11","4","20","55.56"
"596","Paul Cotter","N.J","C","79","967.23333333333","15","5","3","2","20","74.07"
"602","Yegor Sharangovich","CGY","C","73","950.81666666667","8","12","8","4","20","74.07"
"669","Alex Newhook","MTL","C","82","1057.7333333333","12","8","5","3","20","55.56"
"729","Mavrik Bourque","DAL","C","73","823.55","9","11","5","6","20","60.61"
"3","Corey Perry","EDM","R","80","828.51666666667","13","6","3","3","19","54.29"
"39","Tyler Myers","VAN","D","71","1213.5","4","15","8","7","19","38.00"
"140","William Karlsson","VGK","C","53","707.55","6","13","9","4","19","70.37"
"153","Joel Armia","MTL","R","81","853.95","5","14","10","4","19","76.00"
"164","Morgan Rielly","TOR","D","82","1490.05","4","15","11","4","19","31.15"
"220","Jonny Brodzinski","NYR","C","51","553.55","12","7","3","4","19","82.61"
"238","Ryan Hartman","MIN","R","69","904.88333333333","8","11","8","3","19","59.38"
"255","Valeri Nichushkin","COL","R","43","605.58333333333","11","8","4","4","19","57.58"
"268","Trevor van Riemsdyk","WSH","D","82","1289.65","1","18","8","10","19","32.76"
"312","Michael Bunting","NSH, PIT","L","76","992.71666666667","7","12","9","3","19","51.35"
"320","Jake Middleton","MIN","D","67","1279.0166666667","8","11","7","4","19","40.43"
"393","Mason Appleton","WPG","C","71","958.61666666667","8","11","7","4","19","57.58"
"409","Ryan Lindgren","COL, NYR","D","72","1202.1166666667","4","15","4","11","19","40.43"
"452","Brandon Duhaime","WSH","R","82","889.3","8","11","6","5","19","65.52"
"545","Martin Fehervary","WSH","D","81","1246.3666666667","5","14","8","6","19","35.19"
"572","Kevin Bahl","CGY","D","73","1318.5333333333","2","17","9","8","19","41.30"
"594","Martin Pospisil","CGY","C","81","1014.3666666667","3","16","10","6","19","43.18"
"654","Nicholas Robertson","TOR","L","69","741.96666666667","13","6","4","2","19","67.86"
"656","Jakob Pelletier","CGY, PHI","L","49","517.21666666667","7","12","5","7","19","82.61"
"718","Lukas Reichel","CHI","L","70","730.13333333333","8","11","6","5","19","86.36"
"22","Patrick Maroon","CHI","L","68","707.78333333333","4","14","11","3","18","72.00"
"33","Lars Eller","PIT, WSH","C","80","928.01666666667","9","9","7","2","18","64.29"
"71","Mattias Ekholm","EDM","D","64","1171.5166666667","3","15","7","8","18","32.73"
"80","Nick Jensen","OTT","D","71","1219.6","2","16","6","10","18","33.33"
"124","Dylan DeMelo","WPG","D","82","1534.2333333333","3","15","7","8","18","25.71"
"125","Nick Seeler","PHI","D","77","1175.0333333333","3","15","7","8","18","34.62"
"169","Brady Skjei","NSH","D","82","1396.4166666667","6","12","4","8","18","40.91"
"186","Esa Lindell","DAL","D","80","1402.6666666667","3","15","7","8","18","27.27"
"199","Jaccob Slavin","CAR","D","80","1397.5833333333","6","12","4","8","18","28.57"
"232","Andrew Copp","DET","C","56","722.08333333333","6","12","9","3","18","66.67"
"271","Garnet Hathaway","PHI","R","67","685.85","8","10","4","6","18","69.23"
"274","Aaron Ekblad","FLA","D","56","970.65","3","15","6","9","18","40.91"
"329","Rasmus Andersson","CGY","D","81","1455.5166666667","8","10","4","6","18","42.86"
"403","Brandon Tanev","SEA, WPG","L","79","859.76666666667","8","10","6","4","18","72.00"
"516","Filip Chytil","NYR, VAN","C","56","715.46666666667","11","7","3","4","18","64.29"
"518","Alex Iafallo","WPG","L","82","812.95","8","10","7","3","18","50.00"
"530","Nick Perbix","T.B","D","74","1043.7833333333","6","12","7","5","18","40.00"
"532","Alexey Toropchenko","STL","R","80","884.28333333333","4","14","6","8","18","72.00"
"546","Joel Farabee","CGY, PHI","L","81","1022.95","9","9","7","2","18","60.00"
"591","Alexander Romanov","NYI","D","64","1243.8333333333","4","14","7","7","18","35.29"
"610","Logan O'Connor","COL","R","80","938.65","9","9","4","5","18","81.82"
"635","Moritz Seider","DET","D","82","1533.1166666667","4","14","6","8","18","31.58"
"671","Joel Kiviranta","COL","L","79","853.43333333333","12","6","4","2","18","62.07"
"690","Drew O'Connor","PIT, VAN","L","84","1042.9833333333","6","12","6","6","18","58.06"
"704","Ridly Greig","OTT","C","78","1007.8166666667","7","11","8","3","18","50.00"
"745","Gage Goncalves","T.B","C","60","726.86666666667","7","11","7","4","18","56.25"
"786","Mackie Samoskevich","FLA","R","72","808.25","10","8","6","2","18","66.67"
"813","Ryker Evans","SEA","D","73","1254.4","4","14","7","7","18","39.13"
"43","Roman Josi","NSH","D","53","979.83333333333","5","12","8","4","17","45.95"
"45","Adam Henrique","EDM","C","80","950.98333333333","9","8","4","4","17","53.13"
"70","Brian Dumoulin","ANA, N.J","D","79","1332.6666666667","1","16","9","7","17","36.96"
"81","Nic Dowd","WSH","C","82","991","10","7","4","3","17","48.57"
"96","Nick Bjugstad","UTA","C","66","756.11666666667","6","11","8","3","17","58.62"
"138","Joel Edmundson","L.A","D","73","1300.3833333333","5","12","6","6","17","26.56"
"154","Connor Murphy","CHI","D","68","1216.7","1","16","3","13","17","39.53"
"190","Adam Pelech","NYI","D","60","1091.8833333333","0","17","4","13","17","42.50"
"285","Travis Sanheim","PHI","D","82","1643.25","7","10","6","4","17","24.64"
"394","Steven Lorentz","TOR","C","80","739.91666666667","6","11","5","6","17","70.83"
"396","Jalen Chatfield","CAR","D","79","1312.1333333333","7","10","4","6","17","28.33"
"462","Michael Carcone","UTA","L","53","555.83333333333","7","10","3","7","17","65.38"
"474","Zach Aston-Reese","CBJ","C","79","941.1","6","11","6","5","17","56.67"
"486","Cody Glass","N.J, PIT","C","65","740.46666666667","5","12","10","2","17","62.96"
"522","Eetu Luostarinen","FLA","C","80","994.25","7","10","5","5","17","51.52"
"590","Jonatan Berggren","DET","R","75","897.76666666667","8","9","7","2","17","70.83"
"695","Braden Schneider","NYR","D","80","1255.85","4","13","5","8","17","32.08"
"712","Jake Sanderson","OTT","D","80","1337.0333333333","5","12","5","7","17","41.46"
"818","Emil Lilleberg","T.B","D","76","1089.2666666667","1","16","8","8","17","44.74"
"41","Jordan Eberle","SEA","R","42","538.9","6","10","9","1","16","64.00"
"50","Jared Spurgeon","MIN","D","66","1125.6","5","11","5","6","16","36.36"
"65","Brayden McNabb","VGK","D","82","1439.5833333333","4","12","7","5","16","23.53"
"73","Craig Smith","CHI, DET","C","59","610.6","7","9","7","2","16","59.26"
"126","Sean Kuraly","CBJ","C","82","870.95","5","11","9","2","16","51.61"
"150","Jonas Brodin","MIN","D","50","1006.3","4","12","3","9","16","40.00"
"172","Mark Jankowski","CAR, NSH","C, L","60","620.58333333333","11","5","4","1","16","76.19"
"173","Olli Maatta","DET, UTA","D","77","1320.1333333333","2","14","8","6","16","35.56"
"260","Nikita Zadorov","BOS","D","81","1417.85","2","14","5","9","16","29.63"
"349","Tommy Novak","NSH, PIT","C","54","620.96666666667","12","4","4","0","16","76.19"
"368","Lawson Crouse","UTA","L","81","942.63333333333","11","5","2","3","16","51.61"
"406","Luke Kunin","CBJ, S.J","C","75","901.38333333333","10","6","3","3","16","61.54"
"460","Michael Eyssimont","SEA, T.B","C","77","807.76666666667","9","7","3","4","16","57.14"
"463","Justin Brazeau","BOS, MIN","R","76","800","6","10","7","3","16","69.57"
"472","Justin Danforth","CBJ","R","61","720.73333333333","7","9","6","3","16","61.54"
"489","Urho Vaakanainen","ANA, NYR","D","51","785.43333333333","2","14","6","8","16","48.48"
"524","Johnathan Kovacevic","N.J","D","81","1362.3166666667","1","15","9","6","16","34.04"
"536","Sean Walker","CAR","D","82","1236.0333333333","5","11","6","5","16","35.56"
"598","Cole Koepke","BOS","L","73","752.48333333333","9","7","5","2","16","66.67"
"617","Blake Lizotte","PIT","C","59","654.18333333333","8","8","5","3","16","76.19"
"648","Alex Vlasic","CHI","D","82","1504.1333333333","3","13","6","7","16","26.23"
"651","Philip Tomasino","NSH, PIT","C, R","61","700.11666666667","8","8","6","2","16","69.57"
"696","Connor Zary","CGY","C","54","716.5","10","6","2","4","16","80.00"
"850","Pavel Mintyukov","ANA","D","67","1036.8333333333","5","11","7","4","16","32.00"
"852","Frank Nazar","CHI","C","53","677.63333333333","6","10","6","4","16","64.00"
"21","Ian Cole","UTA","D","82","1374.9333333333","1","14","7","7","15","29.41"
"75","David Savard","MTL","D","75","974.71666666667","1","14","5","9","15","51.72"
"78","Erik Haula","N.J","L","69","832.96666666667","8","7","4","3","15","48.39"
"84","Radko Gudas","ANA","D","80","1360.9","0","15","11","4","15","30.61"
"114","Sam Carrick","NYR","C","80","850.15","4","11","6","5","15","57.69"
"174","Mike Matheson","MTL","D","80","1448.9666666667","3","12","8","4","15","26.32"
"194","Colton Sissons","NSH","C","72","827.33333333333","6","9","8","1","15","62.50"
"245","Brett Pesce","N.J","D","72","1305.3833333333","1","14","9","5","15","34.88"
"249","Seth Jones","CHI, FLA","D","63","1138.65","4","11","7","4","15","35.71"
"259","Ryan Pulock","NYI","D","74","1268.1166666667","4","11","7","4","15","32.61"
"265","Nathan Walker","STL","L","73","812.68333333333","8","7","4","3","15","68.18"
"318","Pierre Engvall","NYI","L","62","719.08333333333","8","7","2","5","15","65.22"
"343","A.J. Greer","FLA","L","81","728.01666666667","4","11","10","1","15","68.18"
"372","Joel Eriksson Ek","MIN","C","46","623.43333333333","8","7","4","3","15","57.69"
"504","Miro Heiskanen","DAL","D","50","970.93333333333","4","11","5","6","15","35.71"
"507","Dylan Samberg","WPG","D","60","1077.5333333333","5","10","7","3","15","26.32"
"597","Nikolai Kovalenko","COL, S.J","R","57","641.1","3","12","7","5","15","55.56"
"609","Egor Zamula","PHI","D","63","944.55","3","12","5","7","15","40.54"
"620","Brett Leason","ANA","R","61","648.13333333333","4","11","4","7","15","65.22"
"700","Kaiden Guhle","MTL","D","55","1004.65","6","9","6","3","15","36.59"
"720","Brock Faber","MIN","D","78","1544.4666666667","7","8","1","7","15","31.25"
"761","Mason Lohrei","BOS","D","77","1242.8","4","11","2","9","15","28.85"
"770","Josh Doan","UTA","R","51","600.08333333333","4","11","7","4","15","68.18"
"10","Kris Letang","PIT","D","74","1370.8666666667","4","10","2","8","14","27.45"
"37","Zach Bogosian","MIN","D","81","1111.95","4","10","5","5","14","41.18"
"47","Gustav Nyquist","MIN, NSH","C, R","79","1014.1833333333","3","11","5","6","14","53.85"
"83","Brenden Dillon","N.J","D","82","1267.5666666667","2","12","1","11","14","25.00"
"93","Justin Faulk","STL","D","78","1402.25","2","12","5","7","14","35.90"
"98","Kevin Hayes","PIT","R","64","612.06666666667","8","6","3","3","14","63.64"
"108","Tyler Seguin","DAL","C","20","248.4","4","10","6","4","14","77.78"
"130","Nick Cousins","OTT","C","50","580.31666666667","6","8","5","3","14","60.87"
"136","Boone Jenner","CBJ","C","26","356.86666666667","4","10","6","4","14","56.00"
"151","Jamie Oleksiak","SEA","D","82","1271.2333333333","4","10","7","3","14","32.56"
"213","Nate Schmidt","FLA","D","80","1139.2","5","9","4","5","14","33.33"
"226","Mattias Janmark","EDM","C","79","914.21666666667","1","13","8","5","14","60.87"
"376","John Marino","UTA","D","35","625.16666666667","1","13","7","6","14","46.67"
"384","Will Borgen","NYR, SEA","D","84","1296.1333333333","4","10","4","6","14","26.92"
"410","Charlie McAvoy","BOS","D","50","869.31666666667","4","10","3","7","14","41.18"
"431","Logan Stanley","WPG","D","63","890.28333333333","1","13","4","9","14","50.00"
"480","Conor Timmins","PIT, TOR","D","68","993.78333333333","3","11","5","6","14","35.90"
"481","Mario Ferraro","S.J","D","78","1408.2166666667","4","10","6","4","14","26.42"
"509","Josh Norris","BUF, OTT","C","56","673.16666666667","10","4","2","2","14","66.67"
"554","Joe Veleno","CHI, DET","C","74","836.33333333333","8","6","2","4","14","77.78"
"562","Jack Drury","CAR, COL","C","72","756.83333333333","6","8","3","5","14","58.33"
"564","Oskar Bäck","DAL","C","73","736.48333333333","4","10","7","3","14","77.78"
"636","Cam York","PHI","D","66","1187.2666666667","4","10","3","7","14","31.11"
"675","Juuso Parssinen","COL, NSH, NYR","C","48","469.88333333333","6","8","4","4","14","87.50"
"677","Matias Maccelli","UTA","L","55","653.4","8","6","4","2","14","70.00"
"693","Mitchell Chaffee","T.B","R","66","709.83333333333","8","6","3","3","14","56.00"
"1","Ryan Suter","STL","D","82","1396.8666666667","1","12","7","5","13","22.41"
"31","Max Pacioretty","TOR","L","37","446.01666666667","5","8","4","4","13","68.42"
"64","Chris Kreider","NYR","L","68","760.45","7","6","3","3","13","41.94"
"67","Tomas Tatar","N.J","L","74","747.65","6","7","2","5","13","54.17"
"122","Josh Manson","COL","D","48","768.68333333333","1","12","5","7","13","48.15"
"188","Shayne Gostisbehere","CAR","D","70","992.43333333333","3","10","3","7","13","29.55"
"218","Connor Clifton","BUF","D","73","956.9","1","12","6","6","13","33.33"
"219","Carson Soucy","NYR, VAN","D","75","1155.15","4","9","3","6","13","34.21"
"235","Michael McCarron","NSH","C, R","74","820.5","5","8","4","4","13","61.90"
"237","Jason Dickinson","CHI","C","59","742.78333333333","6","7","3","4","13","54.17"
"289","Robby Fabbri","ANA","C","44","595.21666666667","8","5","4","1","13","72.22"
"290","Kasperi Kapanen","EDM, STL","R","66","725.98333333333","6","7","5","2","13","61.90"
"354","Mathew Barzal","NYI","C","30","480.06666666667","3","10","8","2","13","54.17"
"367","Mathieu Joseph","STL","R","60","642.95","3","10","6","4","13","65.00"
"400","Ryan Lomberg","CGY","L","80","677.81666666667","3","10","7","3","13","68.42"
"427","Andrew Peeke","BOS","D","76","1235.1333333333","0","13","9","4","13","32.50"
"465","Tanner Jeannot","L.A","L","67","727.78333333333","7","6","2","4","13","54.17"
"484","Michael Rasmussen","DET","C","77","862.53333333333","7","6","3","3","13","46.43"
"533","Morgan Barron","WPG","C","74","667.65","6","7","5","2","13","65.00"
"537","Mark Kastelic","BOS","C","61","624.35","5","8","6","2","13","68.42"
"539","Parker Kelly","COL","C","80","844.16666666667","6","7","5","2","13","68.42"
"541","Zach Whitecloud","VGK","D","74","1201.1","4","9","5","4","13","29.55"
"585","Ilya Lyubushkin","DAL","D","80","1176.35","1","12","4","8","13","28.26"
"616","Nico Sturm","FLA, S.J","C","62","561.46666666667","6","7","5","2","13","76.47"
"623","Kirby Dach","MTL","C","57","712.8","7","6","1","5","13","59.09"
"657","Jayden Struble","MTL","D","56","791.96666666667","2","11","5","6","13","40.63"
"727","Jamie Drysdale","PHI","D","70","1172.3333333333","5","8","5","3","13","25.00"
"757","Emil Heineman","MTL","L","62","636.93333333333","7","6","4","2","13","61.90"
"794","Zachary L'Heureux","NSH","L","62","675.45","4","9","5","4","13","52.00"
"898","Sam Malinski","COL","D","76","1144.2","4","9","5","4","13","28.26"
"899","Uvis Balinskis","FLA","D","76","996.66666666667","4","9","2","7","13","41.94"
"74","Casey Cizikas","NYI","C","82","967.85","5","7","5","2","12","48.00"
"77","Ben Chiarot","DET","D","81","1507.8","4","8","6","2","12","23.53"
"120","Colin Blackwell","DAL","C","63","597.03333333333","3","9","5","4","12","57.14"
"159","Colin Miller","WPG","D","60","818.51666666667","3","9","6","3","12","42.86"
"182","Radek Faksa","STL","C","70","798.21666666667","5","7","6","1","12","46.15"
"185","Oskar Sundqvist","STL","C","67","719.4","2","10","7","3","12","57.14"
"253","Rasmus Ristolainen","PHI","D","63","1048.8666666667","2","10","3","7","12","30.77"
"341","Erik Cernak","T.B","D","76","1165.0333333333","2","10","6","4","12","24.00"
"425","Trent Frederic","BOS, EDM","C","58","704","7","5","3","2","12","63.16"
"547","Philipp Kurashev","CHI","C","51","618.28333333333","5","7","3","4","12","85.71"
"553","Mattias Samuelsson","BUF","D","62","984.05","3","9","5","4","12","28.57"
"588","Pontus Holmberg","TOR","R","68","781.91666666667","2","10","5","5","12","54.55"
"645","Drew Helleson","ANA","D","55","838.45","4","8","6","2","12","33.33"
"647","Henry Thrun","S.J","D","60","946.33333333333","2","10","2","8","12","40.00"
"715","Justin Barron","MTL, NSH","D","62","965.28333333333","6","6","2","4","12","34.29"
"809","Olen Zellweger","ANA","D","62","967.66666666667","4","8","5","3","12","29.27"
"847","Denton Mateychuk","CBJ","D","45","712.18333333333","4","8","6","2","12","33.33"
"62","Dmitry Kulikov","FLA","D","70","1159.5833333333","3","8","2","6","11","24.44"
"85","Chris Tanev","TOR","D","75","1228.4666666667","2","9","4","5","11","20.00"
"287","Tony DeAngelo","NYI","D","35","651.31666666667","2","9","5","4","11","40.74"
"315","Dakota Joshua","VAN","C","57","666.31666666667","5","6","5","1","11","61.11"
"316","Kevin Labanc","CBJ","R","34","332.03333333333","2","9","2","7","11","84.62"
"352","Brandon Carlo","BOS, TOR","D","83","1315.5666666667","1","10","1","9","11","23.91"
"377","Yakov Trenin","MIN","C","76","846.85","5","6","3","3","11","44.00"
"478","Nicolas Hague","VGK","D","68","1075","4","7","2","5","11","28.21"
"506","Timothy Liljegren","S.J, TOR","D","68","1121.6833333333","4","7","1","6","11","28.21"
"519","David Kampf","TOR","C","59","590.98333333333","4","7","6","1","11","64.71"
"561","Ty Emberson","EDM","D","75","976.93333333333","2","9","6","3","11","30.56"
"608","Brayden Pachal","CGY","D","76","975.63333333333","3","8","4","4","11","31.43"
"612","Kyle MacLean","NYI","C","81","775.28333333333","4","7","4","3","11","57.89"
"681","Elmer Soderblom","DET","L","26","331.35","4","7","3","4","11","73.33"
"687","Tye Kartye","SEA","L","63","575.16666666667","5","6","2","4","11","57.89"
"691","Cole Smith","NSH","L, R","71","782.26666666667","4","7","4","3","11","55.00"
"769","Janis Moser","T.B","D","54","872.11666666667","1","10","3","7","11","25.58"
"831","Conor Geekie","T.B","C","52","594.8","7","4","4","0","11","52.38"
"25","David Perron","OTT","L","43","500.75","5","5","3","2","10","52.63"
"32","Alec Martinez","CHI","D","44","722.81666666667","5","5","0","5","10","35.71"
"97","Derek Forbort","VAN","D","54","778.23333333333","2","8","3","5","10","47.62"
"180","Jacob Trouba","ANA, NYR","D","76","1317.2166666667","1","9","8","1","10","19.23"
"243","William Carrier","CAR","L","43","482.78333333333","3","7","4","3","10","52.63"
"269","Jordan Oesterle","BOS, NSH","D","37","593.58333333333","4","6","3","3","10","38.46"
"282","Jakub Vrana","NSH, WSH","L","39","371.43333333333","5","5","3","2","10","66.67"
"381","Noel Acciari","PIT","C","79","878.16666666667","4","6","4","2","10","52.63"
"415","Patrik Laine","MTL","L","52","559.71666666667","3","7","3","4","10","58.82"
"423","Beck Malenstyn","BUF","L","76","678.81666666667","4","6","5","1","10","58.82"
"626","Kaedan Korczak","VGK","D","40","588.31666666667","0","10","5","5","10","32.26"
"676","Zac Jones","NYR","D","46","699.91666666667","1","9","4","5","10","47.62"
"722","Alexander Holtz","VGK","R","53","580.16666666667","3","7","3","4","10","52.63"
"725","Brett Berard","NYR","L","35","370.31666666667","6","4","1","3","10","76.92"
"742","Marat Khusnutdinov","BOS, MIN","C","75","781.96666666667","5","5","3","2","10","66.67"
"756","Yegor Chinakhov","CBJ","R","30","387.4","5","5","3","2","10","62.50"
"779","Aatu Raty","VAN","C","33","339.4","7","3","1","2","10","66.67"
"804","Fedor Svechkov","NSH","C","52","569.1","5","5","1","4","10","71.43"
"873","Adam Klapka","CGY","R","31","288.51666666667","6","4","4","0","10","83.33"
"34","Drew Doughty","L.A","D","30","562.95","2","7","2","5","9","37.50"
"46","TJ Brodie","CHI","D","54","806.85","2","7","0","7","9","39.13"
"166","Mathew Dumba","DAL","D","63","895.4","1","8","6","2","9","23.68"
"202","Erik Gustafsson","DET","D","60","853.81666666667","1","8","7","1","9","34.62"
"331","Jonas Siegenthaler","N.J","D","55","923.08333333333","2","7","1","6","9","31.03"
"413","Carl Grundstrom","S.J","R","56","522.21666666667","3","6","5","1","9","75.00"
"418","Jesse Puljujarvi","FLA, PIT","R","31","333.78333333333","4","5","2","3","9","75.00"
"428","Tyson Jost","CAR","C","39","369.55","4","5","1","4","9","64.29"
"503","Henri Jokiharju","BOS, BUF","D","60","968.05","3","6","3","3","9","19.57"
"514","Alexandre Texier","STL","C","31","351.98333333333","5","4","3","1","9","69.23"
"587","Declan Chisholm","MIN","D","66","1031.0666666667","1","8","5","3","9","27.27"
"604","Simon Benoit","TOR","D","78","1108.2666666667","1","8","3","5","9","20.45"
"682","Adam Edstrom","NYR","C","51","466.88333333333","5","4","3","1","9","60.00"
"707","Tyler Kleven","OTT","D","79","1100.4333333333","4","5","3","2","9","31.03"
"719","Sam Colangelo","ANA","R","31","355.66666666667","7","2","2","0","9","47.37"
"764","Daniil Miromanov","CGY","D","44","725.01666666667","2","7","3","4","9","39.13"
"826","Lian Bichsel","DAL","D","38","539.78333333333","4","5","2","3","9","34.62"
"858","Matthew Poitras","BOS","C","33","382.08333333333","1","8","6","2","9","75.00"
"867","Marc Gatcomb","NYI","C","39","377.5","8","1","0","1","9","64.29"
"15","Trevor Lewis","L.A","C","60","562.23333333333","4","4","1","3","8","72.73"
"49","Cam Atkinson","T.B","R","39","319.76666666667","3","5","5","0","8","61.54"
"88","Justin Holl","DET","D","73","983.15","2","6","5","1","8","24.24"
"217","Tyler Motte","DET","C","55","526.56666666667","4","4","3","1","8","57.14"
"227","Anthony Duclair","NYI","L","44","566.03333333333","4","4","4","0","8","47.06"
"230","Miles Wood","COL","L","37","392.76666666667","4","4","1","3","8","61.54"
"301","Justin Kirkland","CGY","C","21","179.55","2","6","4","2","8","80.00"
"339","Jordan Greenway","BUF","L","34","400.05","3","5","4","1","8","44.44"
"402","Kevin Rooney","CGY","C","70","517.85","4","4","1","3","8","50.00"
"430","Joshua Mahura","SEA","D","64","828.08333333333","0","8","4","4","8","24.24"
"438","Dennis Cholowski","N.J, NYI","D","39","451","3","5","2","3","8","47.06"
"447","Jacob Moverare","L.A","D","49","567.16666666667","1","7","2","5","8","30.77"
"521","Jan Rutta","S.J","D","54","820.91666666667","2","6","2","4","8","28.57"
"552","Isac Lundestrom","ANA","C","78","825.83333333333","3","5","3","2","8","42.11"
"574","Adam Boqvist","FLA, NYI","D","35","407.08333333333","3","5","2","3","8","47.06"
"578","Jacob Bernard-Docker","BUF, OTT","D","40","530.06666666667","2","6","3","3","8","32.00"
"579","Jakub Lauko","BOS, MIN","C","56","543.38333333333","3","5","2","3","8","66.67"
"586","Connor Dewar","PIT, TOR","C","48","472.61666666667","3","5","0","5","8","72.73"
"607","Jake Christiansen","CBJ","D","68","803.25","1","7","4","3","8","20.51"
"639","John Beecher","BOS","C","78","746.55","2","6","5","1","8","40.00"
"666","Albert Johansson","DET","D","61","948.75","3","5","1","4","8","27.59"
"685","Marc Del Gaizo","NSH","D","46","707.11666666667","2","6","4","2","8","30.77"
"754","Matt Rempe","NYR","C","42","355.73333333333","3","5","2","3","8","53.33"
"781","Nolan Allan","CHI","D","43","599.06666666667","1","7","3","4","8","42.11"
"868","Nick Blankenburg","NSH","D","60","927.81666666667","2","6","2","4","8","23.53"
"16","Jeff Petry","DET","D","44","750.9","1","6","3","3","7","28.00"
"38","Luke Schenn","NSH, WPG","D","76","1096.65","1","6","2","4","7","20.00"
"61","Calvin de Haan","COL, NYR","D","47","647.58333333333","0","7","4","3","7","30.43"
"135","Scott Mayfield","NYI","D","66","986.28333333333","2","5","2","3","7","15.56"
"191","Jimmy Vesey","COL, NYR","L","43","442.81666666667","5","2","2","0","7","58.33"
"197","Brock McGinn","ANA","L","26","257.75","4","3","2","1","7","63.64"
"205","Vinnie Hinostroza","MIN, NSH","C","38","446.76666666667","2","5","1","4","7","43.75"
"266","Joel Hanley","CGY","D","53","882.73333333333","1","6","1","5","7","20.59"
"273","Tomas Nosek","FLA","L","59","509.28333333333","0","7","5","2","7","46.67"
"278","Haydn Fleury","WPG","D","39","551.13333333333","0","7","4","3","7","53.85"
"310","Sam Lafferty","BUF","C","60","555.21666666667","4","3","1","2","7","63.64"
"347","Christian Fischer","CBJ, DET","R","46","474.83333333333","1","6","3","3","7","63.64"
"356","Parker Wotherspoon","BOS","D","55","885.23333333333","1","6","5","1","7","25.00"
"441","Jake Bean","CGY","D","64","922.9","2","5","2","3","7","24.14"
"444","Nathan Bastian","N.J","R","59","585.45","2","5","3","2","7","63.64"
"450","Troy Stecher","EDM","D","66","860.3","3","4","3","1","7","25.93"
"513","Erik Brannstrom","VAN","D","28","369.61666666667","3","4","3","1","7","50.00"
"525","Jacob Bryson","BUF","D","48","631.13333333333","0","7","5","2","7","26.92"
"566","Rasmus Kupari","WPG","C","59","535.4","4","3","3","0","7","58.33"
"567","Ty Dellandrea","S.J","C","68","712.51666666667","1","6","2","4","7","53.85"
"600","Scott Perunovich","NYI, STL","D","35","502.9","2","5","3","2","7","29.17"
"667","Vladislav Kolyachonok","PIT, UTA","D","35","439.48333333333","2","5","3","2","7","53.85"
"672","Cole Schwindt","VGK","R","42","375.65","0","7","2","5","7","50.00"
"728","Jack Thompson","S.J","D","31","427.28333333333","4","3","2","1","7","53.85"
"731","Hendrix Lapierre","WSH","C","27","244.45","0","7","3","4","7","100.00"
"737","Shakir Mukhamadullin","S.J","D","30","473.03333333333","2","5","2","3","7","53.85"
"749","Artem Zub","OTT","D","56","950.16666666667","1","6","2","4","7","21.21"
"783","Colton Dach","CHI","C","25","285.11666666667","2","5","2","3","7","58.33"
"789","Samuel Helenius","L.A","C","50","428.4","4","3","1","2","7","63.64"
"829","Luca Del Bel Belluz","CBJ","C","15","185.61666666667","2","5","3","2","7","58.33"
"880","Max Sasson","VAN","C","29","294.55","3","4","4","0","7","63.64"
"7","Jack Johnson","CBJ","D","41","458.36666666667","0","6","2","4","6","33.33"
"44","Travis Hamonic","OTT","D","59","886.78333333333","1","5","0","5","6","31.58"
"82","Justin Dowling","N.J","C","52","519.96666666667","1","5","2","3","6","54.55"
"92","Jon Merrill","MIN","D","70","912.76666666667","2","4","2","2","6","20.69"
"161","Barclay Goodrow","S.J","C","77","851.91666666667","3","3","2","1","6","42.86"
"165","Hampus Lindholm","BOS","D","17","238.31666666667","3","3","1","2","6","54.55"
"167","Phillip Di Giuseppe","VAN","L","20","212.86666666667","1","5","2","3","6","75.00"
"175","Zemgus Girgensons","T.B","C","82","822.1","2","4","4","0","6","42.86"
"344","Jansen Harkins","ANA","C","61","570.45","2","4","1","3","6","50.00"
"375","Dennis Gilbert","BUF, OTT","D","29","290.31666666667","0","6","2","4","6","42.86"
"382","Derek Ryan","EDM","C","36","320.63333333333","1","5","2","3","6","66.67"
"437","Noah Gregor","OTT, S.J","L","52","525.85","3","3","2","1","6","85.71"
"494","Klim Kostin","S.J","C","35","336.25","1","5","2","3","6","60.00"
"517","Nick DeSimone","UTA","D","20","299.16666666667","1","5","2","3","6","54.55"
"538","Sean Durzi","UTA","D","30","517.51666666667","2","4","2","2","6","26.09"
"589","Tyler Tucker","STL","D","38","515.48333333333","3","3","1","2","6","35.29"
"592","David Gustafsson","WPG","C","36","312.88333333333","2","4","2","2","6","40.00"
"686","Nikita Nesterenko","ANA","C","20","203.05","4","2","2","0","6","75.00"
"739","Landon Slaggert","CHI","L","33","379.08333333333","2","4","4","0","6","54.55"
"741","Wyatt Kaiser","CHI","D","57","923.05","3","3","2","1","6","18.75"
"753","Mikael Pyyhtia","CBJ","L","47","489.3","3","3","3","0","6","46.15"
"759","Nils Aman","VAN","C","19","193.48333333333","1","5","1","4","6","85.71"
"774","Scott Morrow","CAR","D","14","209.8","1","5","2","3","6","42.86"
"872","Ethen Frank","WSH","C","24","244.41666666667","4","2","1","1","6","54.55"
"876","Victor Mancini","NYR, VAN","D","31","456.61666666667","1","5","1","4","6","50.00"
"910","Collin Graf","S.J","R","33","401.5","3","3","1","2","6","40.00"
"24","Brendan Smith","DAL","D","32","388.15","0","5","2","3","5","38.46"
"63","Nick Leddy","STL","D","31","545.15","2","3","1","2","5","17.24"
"87","Calle Jarnkrok","TOR","C","19","224.85","0","5","3","2","5","71.43"
"162","Luke Glendening","T.B","C","77","684.58333333333","3","2","2","0","5","41.67"
"189","Devin Shore","MIN","C","55","463.13333333333","1","4","2","2","5","71.43"
"261","Curtis Lazar","N.J","C","48","450.1","2","3","2","1","5","62.50"
"262","Anthony Mantha","CGY","R","13","153.7","2","3","2","1","5","62.50"
"321","Matthew Highmore","OTT","C","41","397.98333333333","1","4","3","1","5","62.50"
"346","Oliver Kylington","ANA, COL","D","19","225.3","1","4","4","0","5","71.43"
"398","Rodrigo Abols","PHI","C","22","200.96666666667","2","3","1","2","5","71.43"
"475","Vinni Lettieri","BOS","C","26","318.5","3","2","2","0","5","62.50"
"476","Juuso Valimaki","UTA","D","43","638","2","3","2","1","5","21.74"
"544","Oliver Wahlstrom","BOS, NYI","R","43","396.86666666667","3","2","1","1","5","71.43"
"577","Nils Lundkvist","DAL","D","39","565.25","0","5","3","2","5","25.00"
"581","Jordan Harris","CBJ","D","33","367.06666666667","1","4","3","1","5","35.71"
"819","Arber Xhekaj","MTL","D","70","941.05","1","4","2","2","5","17.86"
"827","Seamus Casey","N.J","D","14","157.36666666667","2","3","2","1","5","62.50"
"832","Isaiah George","NYI","D","33","499.66666666667","1","4","0","4","5","29.41"
"878","Ivan Ivan","COL","C","40","348.31666666667","3","2","0","2","5","41.67"
"106","Erik Gudbranson","CBJ","D","16","238.06666666667","0","4","1","3","4","25.00"
"117","John Klingberg","EDM","D","10","181.06666666667","1","3","1","2","4","50.00"
"222","Hudson Fasching","NYI","R","43","463.56666666667","2","2","1","1","4","44.44"
"233","Ryan Graves","PIT","D","61","808.31666666667","1","3","0","3","4","19.05"
"263","Ross Johnston","ANA","L","43","372.53333333333","1","3","2","1","4","57.14"
"338","Anthony Richard","PHI","C","15","157.68333333333","1","3","3","0","4","57.14"
"364","Daniel Sprong","N.J, SEA, VAN","R","30","304.93333333333","1","3","2","1","4","33.33"
"386","Ryan Shea","PIT","D","39","579.75","2","2","2","0","4","23.53"
"399","Philippe Myers","TOR","D","36","540.85","2","2","0","2","4","22.22"
"479","Jonah Gadjovich","FLA","L","42","344.83333333333","4","0","0","0","4","57.14"
"529","Olle Lycksell","PHI","R","19","207.01666666667","0","4","3","1","4","100.00"
"593","Linus Karlsson","VAN","C","23","228.66666666667","2","2","2","0","4","40.00"
"643","Arthur Kaliyev","NYR","R","14","152.65","3","1","1","0","4","57.14"
"688","Louis Crevier","CHI","D","32","495.43333333333","3","1","0","1","4","22.22"
"723","Emil Andrae","PHI","D","42","641.5","1","3","3","0","4","15.38"
"791","Logan Mailloux","MTL","D","7","106.03333333333","2","2","1","1","4","57.14"
"810","Ethan Del Mastro","CHI","D","24","425.76666666667","2","2","1","1","4","30.77"
"814","Zack Ostapchuk","OTT, S.J","C","56","498.18333333333","1","3","1","2","4","50.00"
"844","Jonathan Lekkerimäki","VAN","R","24","246.38333333333","3","1","1","0","4","50.00"
"849","Fraser Minten","BOS, TOR","C","21","242.23333333333","3","1","1","0","4","66.67"
"855","Liam Ohgren","MIN","L","24","237.88333333333","2","2","1","1","4","57.14"
"890","Oliver Moore","CHI","C","9","110.85","0","4","2","2","4","80.00"
"900","Nikolas Matinpalo","OTT","D","41","513.1","1","3","2","1","4","25.00"
"14","Erik Johnson","COL, PHI","D","36","456.18333333333","1","2","0","2","3","20.00"
"76","Nicolas Deslauriers","PHI","L","31","235.13333333333","2","1","0","1","3","37.50"
"101","Austin Watson","DET","L","13","99.066666666667","3","0","0","0","3","60.00"
"215","Kyle Burroughs","L.A","D","33","242.88333333333","0","3","3","0","3","25.00"
"296","Andreas Englund","L.A, NSH","D","35","440.45","1","2","1","1","3","25.00"
"325","Dryden Hunt","CGY","L","5","57.533333333333","0","3","2","1","3","100.00"
"370","Mitchell Stephens","SEA","C","28","215.58333333333","1","2","2","0","3","75.00"
"453","Lucas Carlsson","S.J","D","13","212.6","1","2","2","0","3","30.00"
"459","Vincent Desharnais","PIT, S.J, VAN","D","51","720","0","3","0","3","3","16.67"
"471","Zack MacEwen","OTT","R","21","161.78333333333","2","1","0","1","3","60.00"
"569","Akil Thomas","L.A","C","25","243.33333333333","1","2","1","1","3","60.00"
"683","Andre Lee","L.A","L","19","171.95","1","2","2","0","3","100.00"
"747","Rory Kerins","CGY","C","5","54.733333333333","0","3","1","2","3","75.00"
"758","Adam Wilsby","NSH","D","23","372","1","2","0","2","3","21.43"
"762","Matthew Kessel","STL","D","29","365.21666666667","0","3","2","1","3","21.43"
"768","Walker Duehr","CGY, S.J","R","24","204.53333333333","2","1","1","0","3","75.00"
"817","Tyson Kozak","BUF","C","21","209.43333333333","2","1","1","0","3","60.00"
"822","Marc McLaughlin","BOS, N.J","C","14","127.3","2","1","1","0","3","75.00"
"835","David Jiricek","CBJ, MIN","D","12","138.16666666667","1","2","1","1","3","60.00"
"843","Maveric Lamoureux","UTA","D","15","228.5","1","2","1","1","3","33.33"
"854","Jani Nyman","SEA","R","12","137.66666666667","1","2","1","1","3","75.00"
"857","Owen Pickering","PIT","D","25","332.53333333333","1","2","0","2","3","33.33"
"862","Jimmy Snuggerud","STL","R","7","90.816666666667","0","3","3","0","3","75.00"
"874","Elias Pettersson","VAN","D","28","348.95","1","2","1","1","3","60.00"
"911","Juha Jaaska","CAR","L","18","156.61666666667","0","3","1","2","3","60.00"
"9","Marc-Edouard Vlasic","S.J","D","27","370.85","1","1","1","0","2","22.22"
"11","Ryan Reaves","TOR","R","35","271.13333333333","0","2","1","1","2","66.67"
"27","Robert Bortuzzo","UTA","D","17","160.6","0","2","1","1","2","66.67"
"48","Matt Martin","NYI","L","32","270.41666666667","0","2","2","0","2","40.00"
"109","Dylan McIlrath","WSH","D","17","192.6","0","2","1","1","2","28.57"
"119","Michael Sgarbossa","WSH","C","3","27.933333333333","1","1","1","0","2","66.67"
"133","Mike Reilly","NYI","D","18","237.78333333333","0","2","2","0","2","33.33"
"139","Matt Nieto","PIT","L","32","322.15","1","1","1","0","2","40.00"
"207","Ben Hutton","VGK","D","11","143.4","0","2","1","1","2","50.00"
"210","Liam O'Brien","UTA","C","28","259.9","0","2","1","1","2","22.22"
"223","John Hayden","SEA","C","20","166.3","1","1","1","0","2","40.00"
"297","Nicolas Aube-Kubel","BUF, NYR","R","22","205.66666666667","1","1","1","0","2","50.00"
"422","Kieffer Bellows","NSH","L","19","190.4","2","0","0","0","2","100.00"
"426","Max Jones","BOS, EDM","L","26","241.25","1","1","1","0","2","66.67"
"434","Keaton Middleton","COL","D","41","439.08333333333","0","2","1","1","2","16.67"
"508","Pierre-Olivier Joseph","PIT, STL","D","47","649.1","0","2","1","1","2","13.33"
"605","Cole Reinhardt","OTT","L","17","139.43333333333","1","1","1","0","2","50.00"
"611","John Ludvig","COL","D","8","101.11666666667","0","2","0","2","2","100.00"
"619","Noah Philp","EDM","C","15","133.35","0","2","1","1","2","40.00"
"765","Alex Steeves","TOR","C","7","66.65","1","1","0","1","2","66.67"
"797","Brennan Othmann","NYR","L","22","214.5","0","2","1","1","2","16.67"
"798","Joshua Roy","MTL","R","12","129.98333333333","2","0","0","0","2","66.67"
"800","Ville Koivunen","PIT","R","8","118.25","0","2","2","0","2","100.00"
"802","Fabian Lysell","BOS","R","12","146.73333333333","0","2","2","0","2","40.00"
"806","Justin Robidas","CAR","C","2","21.733333333333","1","1","1","0","2","100.00"
"807","Nikita Chibrikov","WPG","R","4","42.333333333333","2","0","0","0","2","100.00"
"839","Kevin Korchinski","CHI","D","16","253.85","1","1","0","1","2","16.67"
"845","Cam Lund","S.J","C","11","113.35","1","1","1","0","2","50.00"
"848","Rutger McGroarty","PIT","R","8","106.96666666667","0","2","2","0","2","66.67"
"851","Ivan Miroshnichenko","WSH","L","18","150.43333333333","0","2","1","1","2","50.00"
"853","Simon Nemec","N.J","D","27","365.38333333333","2","0","0","0","2","25.00"
"859","Sam Rinzel","CHI","D","9","165.76666666667","0","2","0","2","2","33.33"
"905","Artyom Levshunov","CHI","D","18","325.01666666667","0","2","1","1","2","22.22"
"915","Ivan Demidov","MTL","R","2","20.65","1","1","1","0","2","100.00"
"51","Tyler Johnson","BOS","C","9","105.25","0","1","0","1","1","25.00"
"68","Tyson Barrie","CGY","D","13","177.36666666667","1","0","0","0","1","25.00"
"103","Chris Wagner","COL","R","28","182.6","1","0","0","0","1","100.00"
"116","Kevin Gravel","NSH","D","6","99.066666666667","0","1","1","0","1","25.00"
"128","T.J. Tynan","COL","C","9","61.9","0","1","0","1","1","100.00"
"134","Joseph LaBate","CBJ","C","6","54.633333333333","0","1","0","1","1","33.33"
"200","Andreas Athanasiou","CHI","C","8","78.633333333333","1","0","0","0","1","25.00"
"214","Chad Ruhwedel","NYR","D","5","58.433333333333","0","1","1","0","1","33.33"
"221","Joshua Brown","EDM","D","10","109.6","0","1","0","1","1","50.00"
"270","Patrick Brown","BOS","C","15","144.03333333333","0","1","1","0","1","100.00"
"307","William Lagesson","DET","D","7","96.016666666667","0","1","0","1","1","33.33"
"314","Clark Bishop","CGY","C","6","39.666666666667","1","0","0","0","1","100.00"
"322","Bokondji Imama","PIT","L","16","89.633333333333","1","0","0","0","1","25.00"
"365","Jeremy Lauzon","NSH","D","28","411.95","0","1","0","1","1","12.50"
"401","Andrew Poturalski","S.J","C","3","39.516666666667","0","1","0","1","1","100.00"
"405","Joey Anderson","CHI","R","18","190.53333333333","0","1","1","0","1","33.33"
"451","Drake Caggiula","EDM","L","7","50.216666666667","0","1","1","0","1","50.00"
"455","Joona Koppanen","PIT","L","11","126.35","1","0","0","0","1","25.00"
"458","Tanner Laczynski","VGK","C","8","66.7","1","0","0","0","1","100.00"
"473","Dominik Shine","DET","R","9","77.2","0","1","0","1","1","33.33"
"477","Kailer Yamamoto","UTA","R","12","133.2","1","0","0","0","1","50.00"
"482","Cale Fleury","SEA","D","14","162.23333333333","0","1","0","1","1","16.67"
"485","Jaret Anderson-Dolan","WPG","C","7","68.8","0","1","1","0","1","33.33"
"512","Ian Mitchell","BOS","D","15","215.36666666667","0","1","0","1","1","12.50"
"526","Emil Bemstrom","PIT","C","14","112.5","0","1","1","0","1","100.00"
"534","Skyler Brind'Amour","CAR","C","2","26.1","1","0","0","0","1","100.00"
"535","Grant Hutton","NYI","D","13","157.68333333333","0","1","0","1","1","25.00"
"557","Patrick Giles","FLA, S.J","R","17","149.31666666667","1","0","0","0","1","50.00"
"558","Michael Callahan","BOS","D","17","221.95","1","0","0","0","1","11.11"
"580","Ty Smith","CAR","D","8","87.616666666667","0","1","1","0","1","25.00"
"595","Jack St. Ivany","PIT","D","19","263.43333333333","0","1","0","1","1","14.29"
"601","Angus Crookshank","OTT","L","8","77.883333333333","0","1","1","0","1","33.33"
"621","Nolan Foote","N.J","L","7","67.916666666667","0","1","0","1","1","33.33"
"641","John Farinacci","BOS","C","1","10.05","1","0","0","0","1","100.00"
"649","Ville Heinola","WPG","D","18","247.48333333333","0","1","0","1","1","11.11"
"655","Sam Poulin","PIT","R","7","68.7","0","1","0","1","1","50.00"
"674","Valtteri Puustinen","PIT","R","13","113.91666666667","0","1","1","0","1","50.00"
"678","Mat?j  Blümel","DAL","R","7","58.4","1","0","0","0","1","100.00"
"701","Justin Sourdif","FLA","R","1","9.45","1","0","0","0","1","100.00"
"709","Danil Gushchin","S.J","L","12","127","0","1","1","0","1","33.33"
"711","Ozzy Wiesblatt","NSH","C","5","52.466666666667","0","1","1","0","1","50.00"
"738","Helge Grans","PHI","D","6","81.716666666667","0","1","0","1","1","33.33"
"743","Ian Moore","ANA","D","3","40.916666666667","0","1","0","1","1","100.00"
"744","Isaak Phillips","CHI","D","3","34.6","1","0","0","0","1","50.00"
"746","Ethan Cardwell","S.J","R","6","62.133333333333","1","0","0","0","1","50.00"
"750","Callahan Burke","VGK","C","7","75.183333333333","1","0","0","0","1","25.00"
"752","Jeff Malott","L.A","L","12","119.48333333333","0","1","0","1","1","50.00"
"755","Ilya Solovyov","CGY","D","5","64.866666666667","0","1","1","0","1","100.00"
"766","Mike Hardman","N.J","L","2","17.916666666667","0","1","0","1","1","100.00"
"767","Matt Kiersted","FLA","D","2","23.033333333333","0","1","0","1","1","100.00"
"772","Dylan Duke","T.B","L","2","15.716666666667","1","0","0","0","1","100.00"
"799","Ryan Winterton","SEA","C","12","128","0","1","1","0","1","33.33"
"803","Isak Rosen","BUF","R","8","74.4","0","1","1","0","1","50.00"
"805","Oliver Kapanen","MTL","C","18","167.15","0","1","0","1","1","25.00"
"815","Ville Ottavainen","SEA","D","1","14.083333333333","0","1","0","1","1","100.00"
"821","Arshdeep Bains","VAN","L","13","126.11666666667","1","0","0","0","1","33.33"
"823","Declan Carlile","T.B","D","3","38.65","1","0","0","0","1","50.00"
"825","Owen Beck","MTL","C","12","119.71666666667","0","1","0","1","1","50.00"
"842","Brad Lambert","WPG","C","5","49.616666666667","0","1","0","1","1","100.00"
"860","Matt Savoie","EDM","C","3","48.7","0","1","1","0","1","50.00"
"866","Lucas Condotta","MTL","L","7","55.6","1","0","0","0","1","50.00"
"869","Georgii Merkulov","BOS","C","6","71.616666666667","0","1","1","0","1","33.33"
"870","Wyatt Aamodt","COL","D","2","32.333333333333","1","0","0","0","1","100.00"
"879","Parker Ford","WPG","C","3","22.8","1","0","0","0","1","50.00"
"884","Luca Cagnoni","S.J","D","6","84.966666666667","0","1","0","1","1","100.00"
"891","Bradly Nadeau","CAR","L","2","20.066666666667","0","1","1","0","1","50.00"
"893","Calum Ritchie","COL","C","7","75.3","1","0","0","0","1","100.00"
"896","Matthew Wood","NSH","R","6","63.666666666667","0","1","1","0","1","50.00"
"903","Zayne Parekh","CGY","D","1","18.15","1","0","0","0","1","33.33"
"907","Sam Morton","CGY","C","1","10.833333333333","1","0","0","0","1","100.00"
"908","Justin Hryckowian","DAL","C","5","39.216666666667","0","1","1","0","1","100.00"
"912","Arttu Hyry","DAL","R","5","45.183333333333","0","1","1","0","1","100.00"
"95","Alex Petrovic","DAL","D","5","69.1","0","0","0","0","0","0.00"
"113","Jani Hakanpää","TOR","D","2","26.066666666667","0","0","0","0","0","0.00"
"123","Travis Boyd","MIN","C","3","21.933333333333","0","0","0","0","0","-"
"168","Brendan Gaunce","MIN","C","12","110.5","0","0","0","0","0","-"
"198","Dominic Toninato","WPG","C","5","39.033333333333","0","0","0","0","0","-"
"204","Matthew Benning","S.J","D","7","82.633333333333","0","0","0","0","0","0.00"
"209","Jaycob Megna","FLA","D","8","112.06666666667","0","0","0","0","0","0.00"
"211","Kurtis MacDermid","N.J","L","23","130.71666666667","0","0","0","0","0","0.00"
"212","Scott Sabourin","S.J","R","1","10.45","0","0","0","0","0","-"
"240","Robert Hagg","VGK","D","2","22.283333333333","0","0","0","0","0","-"
"241","Steven Santini","T.B","D","1","11.616666666667","0","0","0","0","0","0.00"
"264","Dakota Mermis","TOR, UTA","D","4","58.016666666667","0","0","0","0","0","0.00"
"267","Conor Sheary","T.B","L","5","55.15","0","0","0","0","0","0.00"
"284","Sonny Milano","WSH","L","3","21.183333333333","0","0","0","0","0","-"
"305","Mark Friedman","VAN","D","5","66.9","0","0","0","0","0","0.00"
"323","Hayden Hodgson","OTT","R","2","17.15","0","0","0","0","0","-"
"332","Colin White","S.J","C","3","20.283333333333","0","0","0","0","0","-"
"337","Travis Dermott","EDM, MIN","D","19","222.45","0","0","0","0","0","0.00"
"357","Caleb Jones","L.A","D","6","68.916666666667","0","0","0","0","0","0.00"
"358","Noah Juulsen","VAN","D","35","472.83333333333","0","0","0","0","0","0.00"
"363","Guillaume Brisebois","VAN","D","3","46.466666666667","0","0","0","0","0","0.00"
"369","Kyle Capobianco","DAL","D","1","10.716666666667","0","0","0","0","0","-"
"411","Julien Gauthier","NYI","R","1","7.7","0","0","0","0","0","-"
"412","Rasmus Asplund","FLA","C","6","45.566666666667","0","0","0","0","0","-"
"416","Cam Dineen","EDM","D","4","60.75","0","0","0","0","0","0.00"
"424","Riley Tufte","BOS","L","6","52.316666666667","0","0","0","0","0","-"
"432","Givani Smith","COL, S.J","R","13","81.683333333333","0","0","0","0","0","-"
"435","Riley Stillman","CAR","D","5","34.1","0","0","0","0","0","0.00"
"445","Brett Murray","BUF","L","3","22.566666666667","0","0","0","0","0","-"
"448","Alex Nylander","TOR","L","5","41.066666666667","0","0","0","0","0","0.00"
"457","Michael Pezzetta","MTL","L","25","148.18333333333","0","0","0","0","0","0.00"
"461","Nathan Clurman","PIT","D","1","11.083333333333","0","0","0","0","0","-"
"464","Dylan Coghlan","WPG","D","6","86.033333333333","0","0","0","0","0","0.00"
"468","Jeffrey Viel","BOS","L","5","38.233333333333","0","0","0","0","0","-"
"469","Alex Barré-Boulet","MTL","C","2","14.066666666667","0","0","0","0","0","-"
"470","Tye Felhaber","COL","L","5","27.4","0","0","0","0","0","-"
"492","Jonas Rondbjerg","VGK","R","13","120.06666666667","0","0","0","0","0","0.00"
"502","Shane Bowers","N.J","C","4","32.5","0","0","0","0","0","0.00"
"515","Cameron Crotty","MIN","D","1","5.1333333333333","0","0","0","0","0","-"
"531","Ben Jones","MIN","C","26","212.46666666667","0","0","0","0","0","0.00"
"556","Alexander Alexeyev","WSH","D","8","123.45","0","0","0","0","0","0.00"
"565","Grigori Denisenko","VGK","L","1","8.45","0","0","0","0","0","-"
"570","Liam Foudy","NYI","C","2","14.9","0","0","0","0","0","-"
"576","Adam Ginning","PHI","D","1","12.566666666667","0","0","0","0","0","-"
"582","Jan Jenik","OTT","C","2","15.383333333333","0","0","0","0","0","-"
"599","Spencer Stastney","NSH","D","23","335","0","0","0","0","0","0.00"
"603","Rafael Harvey-Pinard","MTL","L","1","8.9","0","0","0","0","0","-"
"606","Reese Johnson","MIN","C","3","28.566666666667","0","0","0","0","0","-"
"613","Jake Lucchini","NSH","C","3","28.4","0","0","0","0","0","0.00"
"614","Corey Schueneman","STL","D","4","54.466666666667","0","0","0","0","0","0.00"
"615","Mason Morelli","VGK","L","1","7.45","0","0","0","0","0","-"
"618","Jimmy Schuldt","S.J","D","8","101.48333333333","0","0","0","0","0","-"
"625","Matthew Robertson","NYR","D","2","32.95","0","0","0","0","0","0.00"
"630","Raphael Lavoie","VGK","C","9","84.733333333333","0","0","0","0","0","0.00"
"632","Daniil Misyul","N.J","D","1","12.383333333333","0","0","0","0","0","-"
"634","Samuel Bolduc","NYI","D","1","5.9333333333333","0","0","0","0","0","-"
"644","Domenick Fensore","CAR","D","2","32.35","0","0","0","0","0","0.00"
"646","Ryan Johnson","BUF","D","3","50.9","0","0","0","0","0","-"
"650","Ryan Suzuki","CAR","C","2","13.183333333333","0","0","0","0","0","0.00"
"658","Nathan Légaré","N.J","R","3","31.65","0","0","0","0","0","-"
"661","Tobias Bjornfot","FLA","D","14","174.93333333333","0","0","0","0","0","0.00"
"680","Maxwell Crozier","T.B","D","5","83","0","0","0","0","0","0.00"
"684","Matt Stienburg","COL","C","8","43.5","0","0","0","0","0","0.00"
"689","Jacob Gaucher","PHI","C","4","29.366666666667","0","0","0","0","0","0.00"
"692","Connor Mackey","NYR","D","2","29.25","0","0","0","0","0","0.00"
"694","Jack Ahcan","COL","D","2","29.283333333333","0","0","0","0","0","0.00"
"703","Jack Finley","T.B","C","1","8.4166666666667","0","0","0","0","0","0.00"
"706","Daemon Hunt","MIN","D","1","7.4166666666667","0","0","0","0","0","-"
"710","Vasily Ponomarev","PIT","C","7","63.1","0","0","0","0","0","-"
"724","Donovan Sebrango","OTT","D","2","20.616666666667","0","0","0","0","0","-"
"726","Thomas Bordeleau","S.J","C","1","10.116666666667","0","0","0","0","0","-"
"733","Brendan Brisson","VGK","C","9","88.8","0","0","0","0","0","0.00"
"748","Riley Duran","BOS","C","2","24.233333333333","0","0","0","0","0","-"
"760","Chase Bradley","COL","L","2","11.15","0","0","0","0","0","-"
"763","Josh Dunne","BUF","C","2","13.883333333333","0","0","0","0","0","-"
"785","Oskar Olausson","COL","R","2","13.616666666667","0","0","0","0","0","-"
"787","Ryan Ufko","NSH","D","1","15.616666666667","0","0","0","0","0","0.00"
"795","James Malatesta","CBJ","L","2","21.016666666667","0","0","0","0","0","0.00"
"808","Carter Mazur","DET","L","1","1.1666666666667","0","0","0","0","0","-"
"812","Michael Milne","MIN","L","1","6.5666666666667","0","0","0","0","0","-"
"816","Jacob Melanson","SEA","R","1","9.8833333333333","0","0","0","0","0","0.00"
"820","Frederic Brunet","BOS","D","1","13.533333333333","0","0","0","0","0","-"
"824","Taylor Ward","L.A","R","1","13.633333333333","0","0","0","0","0","-"
"833","Ryan Greene","CHI","C","2","23.1","0","0","0","0","0","-"
"836","Devin Kaplan","PHI","R","1","12.2","0","0","0","0","0","-"
"838","Joakim Kemell","NSH","R","2","19.3","0","0","0","0","0","0.00"
"840","Kirill Kudryavtsev","VAN","D","2","25.35","0","0","0","0","0","0.00"
"846","Tristan Luneau","ANA","D","6","94.766666666667","0","0","0","0","0","0.00"
"856","Noah Ostlund","BUF","C","8","78.666666666667","0","0","0","0","0","-"
"864","Brian Halonen","N.J","L","2","23.35","0","0","0","0","0","-"
"865","Owen Sillinger","CBJ","C","1","11.05","0","0","0","0","0","-"
"871","Ben Meyers","SEA","C","8","66.616666666667","0","0","0","0","0","0.00"
"875","Nikita Grebenkin","TOR","R","7","58.966666666667","0","0","0","0","0","-"
"883","Hunter Brzustewicz","CGY","D","1","18.383333333333","0","0","0","0","0","0.00"
"886","Dalibor Dvorsky","STL","C, R","2","17.433333333333","0","0","0","0","0","-"
"888","Samuel Honzek","CGY","L","5","52.566666666667","0","0","0","0","0","0.00"
"889","Ryan Leonard","WSH","R","9","119.93333333333","0","0","0","0","0","0.00"
"892","Gabe Perreault","NYR","R","5","65.433333333333","0","0","0","0","0","-"
"895","Aydar Suniev","CGY","L","1","12.766666666667","0","0","0","0","0","0.00"
"897","Jason Polin","COL","R","2","10.366666666667","0","0","0","0","0","-"
"902","Ty Mueller","VAN","C","2","20.583333333333","0","0","0","0","0","-"
"904","Jett Luchanko","PHI","C","4","43.05","0","0","0","0","0","0.00"
"909","Jacob Quillan","TOR","C","1","4.8666666666667","0","0","0","0","0","-"
"914","Jere Innala","COL","L","17","117.36666666667","0","0","0","0","0","0.00"
"916","Nikita Prishchepov","COL","C","10","63.666666666667","0","0","0","0","0","0.00"
"917","Jack Williams","CBJ","R","1","11.15","0","0","0","0","0","0.00"
"918","Karsen Dorwart","PHI","L","5","49.233333333333","0","0","0","0","0","0.00"
"919","Quinn Hutson","EDM","R","2","26.4","0","0","0","0","0","0.00"
"920","Tim Washe","ANA","C","2","15.466666666667","0","0","0","0","0","0.00"